@{"upper":"false","parenthese":"false","removeAfter":"false","type":"SONG","separator":"-","artistFirst":"true","auteur":"Inrock","sorted":"false","size":"1000","cat":"ALL TIME","rangeB":"0","publish":"2015","name":"Inrock - 1000 morceaux indispensables - 2015","reverseArtist":"false","create":"08/08/2017 23:13:02","rangeE":"2015"}
? And The Mysterians - 96 Tears
13th Floor Elevators - You're Gonna Miss Me
A Tribe Called Quest - Bonita Applebum
Aaliyah - Try Again
ABBA - Dancing Queen
Aerosmith - Walk This Way
Afrika Bambaataa And The Soulsonic Force - Planet Rock
Air - Kelly Watch the Stars
Alice Cooper - Elected
Alicia Keys - If I Ain't Got You
Alton Ellis - I'm Still in Love with You
America - A Horse With No Name
Amy Winehouse - Rehab
Aretha Franklin - Drown in My Own Tears
Arrested Development - Tennessee
Beck - Loser
Bee Gees - Odessa (City on the Black Sea)
Beyonce - Crazy in Love
Big Daddy Kane - Ain't No Half-Steppin'
Big Star - The Ballad of El Goodo
Bill Withers - Ain't No Sunshine
Billie Holiday - Strange Fruit
Blackstreet - No Diggity
Bo Diddley - I'm a Man
Bob Marley And the Wailers - Exodus
Bronski Beat - Smalltown Boy
Bruce Springsteen - Badlands
Buffalo Springfield - For What It's Worth
Busta Rhymes - Break Ya Neck
Buzzcocks - Ever Fallen in Love (With Someone You Shouldn't've)
Canned Heat - On the Road Again
Carpenters - Superstar
Cassius - 1999
Chet Baker - My Funny Valentine
Chicago - If You Leave Me Now
Chris Isaak - Wicked Game
Chuck Berry - Johnny B. Goode
Clispe - Grindin'
Common - The Light
Cream - Sunshine of Your Love
Creedence Clearwater Revival - Born on the Bayou
Crosby, Stills And Nash - Suite: Judy Blue Eyes
Curtis Mayfield - Superfly
Cypress Hill - Insane in the Brain
D'Angelo - Untitled (How Does it Feel)
Deee-Lite - Groove is in the Heart
Deep Purple - Smoke on the Water
Destiny's Child - Bills, Bills, Bills
Dinosaur Jr - Feel the Pain
Dionne Warwick - A House is Not a Home
Doc Gyneco - Dans ma rue
Dolly Parton - Jolene
Donna Summer - I Feel Love
Donny Hathaway - The Ghetto (Live)
Duran Duran - The Chauffeur
Eagles - Hotel California
Echo and the Bunnymen - The Killing Moon
Elastica - Connection
Electric Light Orchestra - Mr. Blue Sky
Elton John And Bernie Taupin - Bennie and the Jets
Elvis Costello - Shipbuilding
Ennio Morricone - Mon nom est personne (My Name Is Nobody)
Eric B And Rakim - I Ain't No Joke
Erykah Badu - Appletree
Faith Evans - Love Like This
Fatboy Slim - The Rockefeller Skank
Fleetwood Mac - Don't Stop
Francois de Roubaix - Dernier domicile connu
Francoise Hardy - Le temps de l'amour
Frank Zappa And The Mothers of Invention - Hungry Freaks, Daddy
Franz Ferdinand - Take Me Out
Free - All Right Now
Fugees - Fu-Gee-La
Gang Starr - JFK 2 LAX
Gary Numan And Tubeway Army - Down in the Park
Gerry and the Pacemakers - You'll Never Walk Alone
Ginuwine - Pony
Giorgio Moroder - (Theme From) Midnight Express
Gladys Knight and the Pips - If I Were Your Woman
Gnarls Barkley - Crazy
Got Your Money - Ol' Dirty Bastard And Kelis
Grace Jones - Pull Up to the Bumper
Gram Parsons - Love Hurts
Grandmaster Flash And The Furious Five - The Message
Grizzly Bear - Two Weeks
Gwen Stefani - Hollaback Girl
Hank Williams - Lost Highway
Harry Nilsson - Everybody's Talking
Herbie Hancock - Rockit
Herman's Hermits - There's a Kind of Hush
Hole - Rock Star
House of Love - Christine
Iggy Pop - The Passenger
Ike And Tina Turner - River Deep, Mountain High
Indeep - Last Night a DJ Saved My Life
Iron Butterfly - In-A-Gadda-Da-Vida
Isaac Hayes - Theme from Shaft
It's Immaterial - Driving Away From Home (Jim's Tune)
Jacno - Rectangle
Jacques Brel - Ne me quitte pas
Janet Jackson - Got 'til It's Gone
Jeff Mills - The Bells
Jefferson Airplane - Somebody to Love
Joan Jett And the Blackhearts - I Love Rock 'n' Roll
John Cale - Paris 1919
John Lee Hooker - Boom Boom
John Lennon - Working Class Hero
Joni Mitchell - River
Juan Atkins - Techno City '95
Julee Cruise - Falling
Jungle Brothers - Because I Got it Like That
Kavinsky - Nightcall
KC And The Sunshine Band - Get Down Tonight
Kelis - Milkshake
Kevin Ayers - May I?
King Crimson - I Talk to the Wind
Kiss - Detroit Rock City
Kris Kross - Jump
Kurtis Blow - The Breaks
Lauryn Hill - Lost Ones
Le Tigre - Deceptacon
Lee Hazlewood - Don't Cry (No More)
Leo Ferre - L'amour fou
Lipps Inc. - Funkytown
Liquid Liquid - Cavern
Louis Armstrong And Ella Fitzgerald - Dream a Little Dream of Me
Love - Alone Again Or
Ludacris - Stand Up
Luther Vandross - Never Too Much
Lynyrd Skynyrd - Free Bird (Live)
M.O.P. - Ante Up
Madlib - Slim's Return
Madness - Our House
Madonna - Lucky Star
Manu Chao - Clandestino
Mary J. Blige - Family Affair
MC Solaar - Caroline
MF DOOM - Doomsday
MIA - Paper Planes
Mike Oldfield - Tubular Bells #1
Miles Davis - So What
Moondog - Lament 1, "Bird's Lament"
Morris Day And The Time - Cool
Mott the Hoople - All the Young Dudes
Muddy Waters - Man(n)ish Boy
Mystikal - Shake Ya Ass
Nancy Sinatra - Bang Bang (My Baby Shot Me Down)
Naughty by Nature - Hip Hop Hooray
Nelly - Hot in Herre
New York Dolls - Personality Crisis
Nico - The Fairest of the Seasons
Noir Desir - Le vent nous portera
Oasis - Supersonic
Ohio Players - Love Rollercoaster
Orchestral Manoeuvres in the Dark - Souvenir
Os Mutantes - Bat Macumba
P. Diddy - Bad Boy for Life
Parliament - Give Up the Funk (Tear the Roof off the Sucker)
Peaches - Fuck the Pain Away
Pearl Jam - Better Man
Peter Bjorn and John - Young Folks
Pharrell Williams - Frontin'
Phoenix - If I Ever Feel Better
Pierre Henry et Michel Colombier - Psyche Rock
Plastic Bertrand - Ca plane pour moi
Queen And David Bowie - Under Pressure
R. Kelly - Ignition (Remix)
R.E.M. - Everybody Hurts
Raekwon - Knuckleheadz
Ram Jam - Black Betty
Ray Charles - Come Rain or Come Shine
Red Hot Chili Peppers - Under the Bridge
Rick James - Mary Jane
Robert Wyatt - Sea Song
Roxy Music - Re-Make/Re-Model
Roy Ayers - Everybody Loves the Sunshine
Roy Orbison - In Dreams
Run-D.M.C. - It's Tricky
Sade - Smooth Operator
Sages Poetes de la Rue - Qu'est-ce qui fait marcher les sages?
Sam Cooke - Nobody Knows the Trouble I've Seen
Santana - Soul Sacrifice
Screamin' Jay Hawkins - I Put a Spell on You
Sebastien Tellier - La Ritournelle
Serguei Prokofiev - Dance of the Knights (I'm not certain that this qualifies for AM)
Sid Vicious - My Way
Silver Apples - Ruby
Simon And Garfunkel - The Sound of Silence
Simple Minds - Don't You (Forget About Me)
Sister Sledge - We Are Family
Slum Village - Fall in Love
Smaal Faces - Lazy Sunday
Snoop Dogg And Pharrell Williams - Drop it Like it's Hot
Soft Cell - Say Hello, Wave Goodbye '91
Sparks - When I'm with You
Stardust - Music Sounds Better with You
Steely Dan - Aja
Stephen Stills - Go Back Home
Steppenwolf - The Pusher
Stevie Ray Vaughn And Double Trouble - Crossfire
Supergrass - Alright
Suzanne Vega - Luka
Syd Barrett - Octopus
T. Rex - Cosmic Dancer
Taxi Girl - Cherchez le Garcon
Technotronic - Pump Up the Jam
Terry Riley - In C
The Animal - The House of the Rising Sun
The B-52's - Give Me Back My Man
The Band - Across the Great Divide
The Beta Band - Dry The Rain
The Black Keys - Lonely Boy
The Breeders - Cannonball
The Buggles - Video Killed the Radio Star
The Cars - Drive
The Chemical Brothers - Hey Boy Hey Girl
The Cramps - Goo Goo Muck
The Diplomats - Dipset Anthem
The Flamin' Groovies - Shake Some Action
The Foundations - Build Me Up Buttercup
The Four Tops - Reach Out I'll Be There
The Grateful Dead - That's It For the Other One
The Human League - Don't You Want Me
The Jackson 5 - A.B.C.
The Jam - That's Entertainment
The Knack - My Sharona
The La's - There She Goes
The Left Banke - - Walk Away Renee
The Lemon Drops - I Live in the Springtime
The Lovin' Spoonful - Summer in the City
The Mamas and the Papas - California Dreamin'
The Monkees - (I'm Not Your) Steppin' Stone
The Pop Group - She is Beyond Good and Evil
The Pretenders - Brass in Pocket
The Ronettes - Be My Baby
The Seeds - Pushin' Too Hard
The Smashing Pumpkins - 1979
The Soft Machine - We Did it Again
The Specials - Ghost Town
The Standells - Dirty Water
The Sugarhill Gang - Rapper's Delight
The Supremes - Baby Love
The Temptations - Ball of Confusion
The Tornados - Telstar
The Turtles - Happy Together
The Verve - Bitter Sweet Symphony
The Waterboys - Fisherman's Blues
The Zombies - A Rose for Emily
Thin Lizzy - The Boys Are Back in Town
Three 6 Mafia - Stay Fly
Tim Buckley - Song to the Siren
Tim Hardin - Reason to Believe
TLC - No Scrubs
Todd Rundgren - Hello It's Me
Townes Van Zandt - For the Sake of the Song
Twista, Kanye West, And Jamie Foxx - Slow Jamz
U2 - One
Urge Overkill - Girl, You'll Be a Woman Soon
Van Morrison - Sweet Thing
Violent Femmes - Gone Daddy Gone
Weezer - Buddy Holly
Wire - Outdoor Miner
Wu-Tang Clan - C.R.E.A.M.
X Men - Retour aux pyramides
XTC - Making Plans for Nigel
Yellow Magic Orchestra - Firecracker
ZZ Top - Gimme All Your Lovin'
10CC - I'm Not in Love
Agnes Obel - Riverside
Alain Kan - Speed My Speed
Alela Diane - The Pirate's Gospel
Alt-J - Matilda
Antony and the Johnsons - Bird Gerhl
Arab Strap - The Shy Retirer
Arnaud Fleurent-Didier - France Culture
Badly Drawn Boy - The Shining
Basehead - Not Over You
Beach House - Walk in the Park
Beirut - Elephant Gun
Belle and Sebastian - The Fox in the Snow
Ben Watt - Some Things Don't Matter
Bon Iver - Flumes
Broadcast - The Book Lovers
Cardinal - Silver Machines
Cat Stevens - Sad Lisa
Chassol - U Were In Love
Children of the Sun - Dead Can Dance
Chris Bell - You and Your Sister
Chromatics - In The City
Cleaners From Venus - Only a Shadow
Cocorosie - Noah's Ark
Cocteau Twins - Sea, Swallow Me
Coldplay - Don't Panic
Colin Blunstone - Smokey Day
Connan Mockasin - Forever Dolphin Love
Damien Jurado - Big Decision
Daniel Darc - Je Me Souviens, Je Me Rappelle
David Ackles - Waiting for the Moving Man
David Lynch - I'm Waiting Here
Day One - Love on the Dole
Deerhunter - Agoraphobia
Dennis Wilson - Farewell My Friend
Derek Bailey - Laura
Devendra Banhart - Hey Mama Wolf
Dick Annegarn - Coutances
Dirty Beaches - True Blue
DJ Krush - Dig This Vibe
Dominique A. - Pour La Peau
Durutti Column - Never Known
Edwyn Collins - Home Again
Eels - Beautiful Freak
Fink - Perfect Darkness
Florence And The Machine - Hospital Beds
Fred Neil - The Dolphins
Fredo Viola - The Sad Song
Galaxie 500 - Pictures
Garbage - Bleed Like Me
Gavin Bryars - Jesus' Blood Has Never Failed Me Yet
Gerard Manset - Il Voyage en Solitaire
Gorillaz - Tomorrow Comes Today
Gruss Rhys - American Interior
Harpers Bizarre - Witchi Tai To
Herman Dune - Bristol
Iron And Wine - The Trapeze Swinger
James Blake - Retrograde
Japan - Nightporter
Jean-Louis Murat - Col de la Croix-Morand
Jose Gonzalez - Heartbeats
Junip - Line of Fire
Karen Dalton - Sweet Substitute
Keaton Henson - You
Kid Cudy - Day 'n' Nite
King Krule - Baby Blue
Lambchop - Soaky in the Pooper
Lana Del Rey - West Coast
Lapland - Metal Lungs
Laurie Anderson - O Superman (for Massenet)
LCD Soundsystem - All My Friends
Lee "Scratch" Perry - Roast Fish and Corn Bread
Lewis - Romance for Two
Lloyd Cole and the Commotions - Perfect Skin
Local Natives - Airplanes
London Grammar - Wasting My Young Years
Low - California
Luscious Jackson - Why Do I Lie?
M. Ward - Chinese Translation
M83 - Teen Angst
Mac Demarco - Ode to Viceroy
Marine Girls - Lazy Ways
Mark Lanegan - I'm Not the Loving Kind
Matthew E. White - Brazos
Mazzy Star - Fade Into You
McCarthy - Frans Hals
Mercury Rev - Holes
Metronomy - Heartbreaker
Michael Nesmith - Different Drum
Michel Polnareff - Le Bal des Laze
Mogwai - I'm Jim Morrison, I'm Dead
Morrissey And Siouxsie - Interlude
Mos Def - Umi Says
Mount Kimbie And King Krule - Meter, Pale, Tone
Nathan Fake - You Are Here
Nick Mulvey - Fever to the Form
Nino Ferrer - La Rue Madureira
Nujabes - Luv(Sic) 2
Okkervil River - The War Criminal Rises and Speaks
Palace Brothers - Riding
Perfume Genius - Dirge
Peter Gabriel - Don't Give Up
Phil Ochs - Jim Dean of Indiana
Plaid - Missing
Psychic TV - The Orchids
Radar Brothers - The Wake of All That's Past
Red House Painters - Uncle Joe
Regina Spektor - Carbon Monoxyde
Ride - Vapour Trail
Roger Quigley - A Kind of Loving
Royksopp - Someone Like Me
Saint Etienne - Only Love Can Break Your Heart
Sam Amidon - My Old Friend
Seu Jorge - Life on Mars?
Shabazz Palaces - Are You... Can You... Were You ? (Felt)
Shearwater - A Hush
Shlohmo - Just Us
Sigur Ros - Agaetis Byrjun
Silver Jews - Tennessee
Slowdive - When the Sun Hits
Sol Seppy - Come Running
Spain - I Love You
Steve Earle - And Worth Blues
Steven Wilson - The Raven That Refused to Sing
Strawberry Switchblade - By The Sea
Sun Kil Moon - Moorestown
Syd Matters - Ill Jackson
Talk Talk - Ascension Day
Television Personalities - Three Wishes
Terry Callier - Love Them From Spartacus (Zero 7 Remix)
The Apartments - Mr. Somewhere
The Black Crowes - Ballad In Urgency
The Blue Nile - Over the Hillside
The Chameleons - Up The Down Escalator
The Field Mice - Sensitive
The Go-Betweens - Bachelor Kisses
The Killers - Mr. Brightside
The Kooks - Seaside
The Loft - Why Does The Rain?
The Lotus Eaters - The First Picture of You
The Magnetic North - Betty Corrigall
The Motels - Total Control
The Passions - I'm In Love With a German Film Star
The Shins - Phantom Limb
The Spinto Band - Oh Mandy
The Stranglers - Golden Brown
The Streets - It's Too Late
The Teardrop Explodes - Tiny Children
The XX - Crystalised
These New Puritans - Fragment Two
Thomas Dybdahl - Running on Fumes
Thrashcan Sinatras - Oranges and Apples
Tim Rose - Come Away, Melinda
Todd Terje And Bryan Ferry - Johnny and Mary
Tom Rush - No Regrets
Trentemoller - Midnight City Remix
Troy Von Balthazar - Took Some $$
Tunng - Bullets
Ultravox - Hiroshima Mon Amour
Unkle (And Richard Ashcroft) - Lonely Soul
Vashti Bunyan - Diamond Day
Vic Chesnutt - Guilty by Association
Villagers - Becoming a Jackal
Vincent Delerm - Le Baiser Modiano
Vincent Gallo - When
Visage - Fade to Grey
Wilco - Deeper Down
Wild Beasts - Loop the Loop
William Fitzsimmons - I Don't Feel It Anymore
Yeah Yeah Yeahs - Maps
Yo La Tengo - Autumn Sweater
Young Fathers - I Heard
10,000 Maniacs - My Mother the War
AC/DC - Hells Bells
Actress - Shadow From Tartarus
Angel Haze - Werkin' Girls
Anticon, Deep Puddle Dynamics - We Ain't Fessin (Double Quotes)
At the Drive-In - Pattern Against User
Atmosphere - Trying to Find a Balance
Bikini Kill - Rebel Girl
Black Dice - Pigs
Black Lips - O Katrina!
Black Sabbath - Paranoid
Blawan - Why They Hide Their Bodies Under my Garage
Blue Cheer - Summertime Blues
Booba - Le Bitume avec une Plume
Boys Noize And Erol Alkan - Lemonade
Brodinski - Can't Help Myself
Cannibal Ox - Straight Off the D.I.C.
Captain Beefheart and his Magic Band - Moonlight On Vermont
Company Flow - End to End Burners
Damned - New Rose
Dead Kennedys - Holiday in Cambodia
Dead Prez - It's Bigger than Hip-Hop
Death - Keep on Knocking
Dizzee Rascal - Sirens
DMX - Ruff Ryders' Anthem
DNA - Blonde Red Head
Drexciya - Depressurization
El-P - The Overly Dramatic Truth
Expression Direkt - Dealer Pour Survivre
Foo Fighters - The Pretender
Fuck Buttons - Surf Solar
Gang of Four - Damaged Goods
Gesaffelstein - Depravity
Grauzone - Eisbaer
Green Velvet - The Red Light
IAM - Demain c'est loin
James Chance and the Contortions - Contort Yourself
Jay Reatard - See/Saw
Julian Casablancas And the Voidz - Human Sadness
Justice - Stress
Kas Product - Loony Bin
Klub des Loosers - Sous le Signe du V
KRS One - Sound of Da Police
Kyuss - El Rodeo
La Femme - Paris 2012
La Rumeur - L'ombre sur la Mesure
Laurent Garnier - Crispy Bacon
Leaf Hound - Freelance Fiend
LFO - Freak
Lil Jon And the East Side Boyz - Get Low
Lil Wayne - A Milli
Living Colour - Cult of Personality
Lydia Lunch - Atomic Bongos
Magazine - Shot By Both Sides
MC5 - Kick Out the Jams
Metallica - Enter Sandman
Method Man - Bring Da Pain
Ministere A.M.E.R. - Sacrifice de Poulets
Minutemen - If Reagan Played Disco
Monks - Complication
Motorhead - Ace of Spades
Mr. Oizo - Douche Beat
Neutral Milk Hotel - Song Against Sex
Nine Inch Nails - Closer
Of Montreal - The Past is a Grotesque Animal
Opeth - The Leper Affinity
Parquet Courts - Borrowed Time
Prodigy - Firestarter
Queens of the Stone Age - No One Knows
Rage Against the Machine - Killing in the Name
Rick Ross - B.M.F.
Sainte Anthony's Fire - Love Over You
Sebastian - Ross Ross Ross
Sham 69 - If The Kids Are United
Spacemen 3 - Revolution
Spank Rock - Top Billin' From Far Left
Spizzenergi - Where's Captain Kirk
Stromae - Bienvenue chez Moi
Suicide - Rocket USA
The Au Pairs - It's Obvious
The Birthday Party - Junkyard
The Dead Weather - No Horse
The Distillers - Drain the Blood
The Gun Club - Sex Beat
The Hives - Hate to Say I Told You So
The Kills - The Good Ones
The Rakes - 22 Grand Job
The Saints - Know Your Product
The Shop Assistants - Safety Net
The Sonics - Psycho
The Vaccines - If You Wanna
The Walkmen - The Rat
The War on Drugs - A Needle In Your Eye #16
Thee Oh Sees - The Dream
Them Crooked Vultures - No One Loves Me And Neither Do I
TNGHT - Higher Ground
TV on the Radio - Stare at the Sun
Valerie June - Workin' Woman Blues
Wolfmother - The Joker and the Thief
2Pac - Hail Mary
Andy Stott - Passed me By
Angelo Badalamenti - Mulholland Drive Main Theme
Autechre - Foil
Bauhaus - Bela Lugosi's Dead
Benjamin Biolay - L'Histoire d'un Garcon
Burial - Archangel
Charles de Goal - Exposition
Charlotte Gainsbourg - Le Chat du Cafe des Artistes
Death in Vegas - Dirge
Diabologum - A Decouvrir Absolument
DJ Shadow - Stem/Long Stem
Dr Dre - Forgot About Dre
Earl Sweatshirt - Whoa
Fat White Family - I Am Mark E Smith
Fauve - De Ceux
Flash and the Pan - Walking in the Rain
Florent Marchet - Apollo 21
Get Well Soon - 5 Steps / 7 Swords
Godspeed You! Black Emperor - The Dead Flag Blues
Goldfrapp - Lovely Head
Gravediggaz - 1-800 Suicide
How To Dress Well - Pour Cyril
Keren Ann - Where No Endings End
Killing Joke - Requiem
Klaus Nomi - The Cold Song
Liars - Broken Witch
Lunatic - Le Crime Paie
Michel Cloup Duo - Vieux Frere
Mike Ladd - Padded Walls
Miossec - Les Chiens de Paille
Miss Kittin And the Hacker - 1982
Mobb Deep - Got It Twisted
Nicolas Jaar - John the Revelator
Nosaj Thing - FOG
Oneohtrix Point Never - Replica
Pere Ubu - 30 Seconds Over Tokyo
Pet Shop Boys - Suburbia
Philip Glass - The Unutterable
Planningtorock - Doorway
Public Image Ltd - Careering
Richard and Linda Thompson - The Great Valerio
RJD2 - June
Robert le Magnifique - Le Poison : 1000 Bruits
RZA - The Drop Off
Sage Francis - Personal Journalist
Scott Walker - It's Raining Today
Silvain Vanot - La Norme
Son Lux - Enough of Our Machines
Soundgarden - Black Hole Sun
Sparklehorse - Spirit Ditch
Spiritualized - Ladies and Gentlemen, We Are Floating in Space
Stina Nordenstam - The Morning Belongs to the Night
Sunn O))) - Mocking Solemnity
Swans - Screen Shot
Tangerine Dream - Birth of Liquid Plejades
Tarwater - The Watersample
The Acid - Creeper
The Horrors - Sea Within a Sea
The Names - Nightshift
The Notwist - Chemicals
The Roots - Don't Say Nuthin'
The Stockholm Monsters - Partyline
The Weeknd - What You Need
Throbbing Gristle - Discipline (Live at Manchester)
Timber Timbre - Run From Me
Tom McRae - You Cut Her Hair
Tortoise - Along the Banks of Rivers
Tricky - Christiansands
Trisomie 21 - La Fete Triste
Tyler the Creator - She
Woodkid - Iron
Young Marble Giants - Searching for Mr Right
!!! - Me And Giuliani Down By The School Yard (A True Story) 
1995 - La Suite 
50 Cent - In Da Club 
808 State - Pacific 202 
A Certain Ratio - Shack Up 
A.R. Kane - A Love From Outter Space
Adam Green - Dance With Me 
Alan Vega, Alex Chilton, Ben Vaughn - Fat City 
Alunageorge - Your Drums, Your Love 
Amadou And Mariam - Sabali 
Amon Duul II - Burning Sister 
Animal Collective - Brothersport 
Anna Calvi - First We Kiss 
Ariel Pink's Haunted Graffiti - Round And Round 
Asap Rocky - Peso 
Asgeir - King And Cross 
Atoms for Peace - Amok 
Avi Buffalo - What's In It For ? 
Baxter Dury - Palm Trees 
Bibio - A tout a l'heure 
Big Audio Dynamite - E=MC2 
Black Strobe - Me And Madonna 
Bloc Party - Banquet 
Blonde Redhead - Silently 
Boards Of Canada - Roygbiv 
Breton - Interference 
Brigitte Fontaine - Je suis inadaptee 
Busdriver - Casting Agent And Cowgirls 
Bush Tetras - You Can't Be Funky 
Cabaret Voltaire - Don't Argue 
Cajmere - Feelin' Kinda High 
Caribou - Odessa 
Cat Power - Cherokee 
Chairlift - Amanaemonesia 
Champs - Blood 
Chapterhouse - Love Forever 
Chilly Gonzales - You Can Dance 
Chris Knox - Not Given Lightly 
Cibo Matto - Sugar Water 
Commodores - Saturday Night 
Crash Course In Science - Flying Turns 
Crocodiles - Endless Flowers 
Cut Copy - Free Your Mind 
Cybotron - Clear 
D4L - Laffy Taffy 
Daf - Liebe Auf Den Ersten Blick (Love At First Sight) 
Damon Albarn - Heavy Seas Of Love 
Daniel Avery - Drone Logic 
Daniel Johnston - Chord Organ Blues 
Daphni - Ye Ye 
Deerhoof - The Perfect Me 
dEUS - Instant Street 
Devo - (I Can't Get No) Satisfaction 
Dexter Wansel - What The World Is Coming To 
Dexys Midnight Runners - Geno 
Die Antwoord - Ugly Boy 
Diplo - Diplo Rhythm 
Dirty Projectors - Swing Lo Magellan 
Disclosure - When A Fire Starts To Burn 
DJ Mujava - Township Funk 
DJ Rashad - Show U How 
Django Django - Hail Bop 
Donovan - Hey Gyp (Dig The Slowness) 
Dopplereffekt - Infophysix 
Drake - Best I Ever Had 
ESG - You're No Good 
Etienne De Crecy - Prix Choc (Radio Edit) 
F.U.S.E. - Approach And Identify 
Factory Floor - Two Different Ways 
Faust - It's A Rainy Day (Sunshine Girl) 
Feist - 1234 
FKA Twigs - Water Me 
Fleet Foxes - White Winter Hymnal 
Flying Lotus - Do The Astral Plane 
Foals - The French Open 
Foster The People - Pumped Up Kicks 
Four Tet - Circling 
Francis Bebey - Divorce pygmee 
Francois And The Atlas Mountains - Les plus beaux 
Frank Ocean - Pyramids 
Friendly Fires - Paris 
Fujiya And Miyagi - Knickerbocker 
Fun Lovin' Criminals - Scooby Snacks 
Futura 2000 - The Escapades Of Futura 2000 
Gamine - Voila les anges 
Geggy Tah - Whoever You Are 
George Duke - Someday 
Glass Animals - Walla Walla 
Glass Candy - Warm In The Winter 
Gold Panda - You 
Grandaddy - A.M. 180 
Grimes - Oblivion 
Guns N' Roses - Paradise City 
Haruomi Hosono - Rokka Bai Mai Beibi 
Hot Chip - Flutes 
Inner City - Big Fun 
Interpol - Obstacle 1 
Isolee - Beau Mot Plage 
Jacques Dutronc - Les gens sont fous, les temps sont flous 
Jagwar Ma - The Throw 
James - Folklore 
James Holden - Renata 
Jamie XX - Far Nearer 
Janelle Monae - Tightrope 
Jean-Paul Sartre Experience - I Like Rain 
JJ - Ecstasy 
Joanna Newsom - Peach, Plum, Pear 
Joe Meek, The Blue Men - I Hear A New World 
John Maus - Believer 
Jon Hopkins - Light Through The Veins 
Jon Lucien - Adoration 
Josef K - Heaven Sent 
Joy Orbison - Hyph Mngo 
Julian Cope - Strasbourg 
Jungle - Lucky I Got What I Want 
Jurassic 5 - Concrete Schoolyard 
Just Jack - Starz In Their Eyes 
Justin Timberlake - My Love 
Kaiser Chiefs - I Predict A Riot 
Kendrick Lamar - The Recipe 
Kerri Chandler - Rain 
Kindness - Cyan 
King Biscuit Time - I Walk The Earth 
Klaxons - Golden Skans 
Kurt Vile - Jesus Fever 
Kylie Minogue - Can't Get You Out Of My Head 
Leon Ware - What's Your Name? 
Les Rita Mitsouko - Le petit train 
Lescop - La Foret 
Lightnin' Rod - Sport 
Lily Allen - The Fear 
Lindstrom - Where You Go I Go Too 
Lizzy Mercier Descloux - Funky Stuff 
Lone - Aquamarine 
Loney, Dear - The City, The Airport 
Lupe Fiasco - Kick Push 
Lush - Etheriel 
Lykke Li - Little Bit 
Machinedrum - DDD 
Major Lazer - Pon De Floor 
Man Parrish - Hip Hop Be Bop (Original Version) 
Mantronix - Who Is It ? 
Manuel Gottsching - E2-E4 (Mondo Disco Edit) 
Marie et les Garcons - Re-bop 
Marquis de Sade - Wanda's Loving Boy 
Masters at Work - Work 
Mathematiques Modernes - Disco Rough 
Matthew Dear - Temptation 
Michel Houellebecq - Presence humaine 
Midnight Juggernauts - Nine Lives 
Mike Jones - Still Tippin 
Mikky Blanco - Wavvy 
Miracle Legion - The Ladies From Town 
Mondkopf - Lambs Are Dancing 
Money Mark - Cry 
Moodymann - Dem Young Sconies 
N.O.R.E. - Nothin' 
Neon Indian - Deadbeat Summer 
Neu ! - Hallogallo 
New Order - The Perfect Kiss 
Nits (The) - J.O.S. Days 
No Doubt - Hella Good 
northside - Shall We Take A Trip? 
Odd Future, OFWGKTA - Oldie 
Orange Juice - Falling And Laughing 
Orbital - The Box 
Outkast - Prototype 
Pale Saints - Sight Of You 
Palma Violets - Best Of Friends 
Panda Bear - Bros 
Papas Fritas - Guys Don't Lie 
Para One - Lean On Me 
Passion Pit - The Reeling 
Patricia - Josephine 
Paul Haig - The Only Truth 
Pavement - Cut Your Hair 
Pearls Before Swine - I Saw The World 
People Under The Stairs - San Francisco Knights 
PEPE BRADOCK - Deep Burnt 
Philippe Katerine - Louxor J'adore 
Pinback - Fortress 
Prefab Sprout - Faron Young 
Psychedelic Furs - Pretty In Pink 
Q-Tip - Let's Ride 
Quando Quango - Love Tempo 
R. Stevie Moore - I Like To Stay Home 
Radio 4 - Dance To The Underground 
Ratatat - Gettysburg 
Real Estate - It's Real 
Redman - Let's Get Dirty (I Can't Get In Da Club) 
Reese And Santonio - The Sound 
Richard Hell, The Voidoids - Blank Generation 
Rock Steady Crew - (Hey You) The Rock Steady Crew 
Rufus And Chaka Khan - Do You Love What You Feel? 
San Fermin - Daedalus (What We Have) 
Santogold - L.E.S Artistes 
SBTRKT - Wildfire 
Scissor Sisters - Comfortably Numb 
Section 25 - Looking From A Hilltop 
Shack - Emergency 
Simian Mobile Disco - It's The Beat 
Siouxsie And The Banshees - Happy House 
Smog - Dress Sexy At My Funeral 
Soul Coughing - Circles 
Soulwax - E Talking (Nite Versions) 
Squarepusher - My Red Hot Car 
St Christopher - All Of A Tremble 
St Germain - So Flute 
St. Vincent - Laughing With A Mouth Of Blood 
Stereolab - The Flower Called Nowhere 
Steve Reich - Different Trains, Part One : America-Before The War
Suede - Beautiful Ones 
Swell - Fuck Even Flow 
Talib Kweli - Get By 
Tame Impala - Alter Ego 
Teriyaki Boyz - I Still Love HER 
The Associates - Party Fears Two 
The Auteurs - Show Girl 
The Avalanches - Since I Left You 
The Bats - Block Of Wood 
The Beautiful South - From Under The Covers 
The Caretaker - Libet's Delay 
The Chi-Lites - That's How Long 
The Chills - Pink Frost 
The Clean - Are You Really On Drugs ?
The Cool Kids - Black Mags 
The Coral - In The Morning 
The Count Five - Psychotic Reaction 
The Creation - Making Time 
The Divine Comedy - Tonight We Fly 
The Dream - Falsetto 
The Drums - Let's Go Surfing 
The Electric Prunes - I Had Too Much To Dream (Last Night) 
The Feelies - Higher Ground 
The Flaming Lips - Silver Trembling Hands 
The Gist - Love At First Sight 
The Go! Team - Ladyflash 
The Gossip - Standing In The Way Of Control 
The Juan MacLean - Happy House 
The Kings Of Leon - The Bucket 
The Knife - Pass This On 
The Last Shadow Puppets - The Meeting Place 
The Lemonheads - It's A Shame About Ray 
The Liminanas - Je ne suis pas tres drogue
The Micronauts - The Jag 
The Monochrome Set - Fun For All The Family 
The Only Ones - Another Girl, Another Planet 
The Orb - Little Fluffy Clouds 
The Other People Place - Sorrow And A Cup Of Joe 
The Pale Fountains - These Are The Things 
The Pastels - If I Could Tell You 
The Pharcyde - Runnin' 
The Polyphonic Spree - It's The Sun 
The Rapture - House Of Jealous Lovers 
The Raveonettes - Love In A Trashcan 
The Shoes - People Movin' 
The Slits - Typical Girls 
The Sugarcubes - Birthday 
The Tammys - Egyptian Shumba 
The The - Uncertain Smile 
The Undertones - Teenage Kicks 
The Wake - Pale Spectre 
The Wannadies - You And Me Song 
The Weather Prophets - Always The Light 
The Verlaines - Death And The Maiden 
The Wild Swans - The Revolutionary Spirit 
The Wolfhounds - The Anti-Midas Touch 
The Wombats - Let's Dance To Joy Division 
The Woodentops - Good Thing 
Thievery Corporation - Heaven's Gonna Burn Your Eyes 
Thundercat - Daylight 
Tiga - (Far From) Home 
Timbaland And Magoo - Drop 
Tinariwen - Arawan 
Tom Tom Club - Wordy Rappinghood 
Toro y Moi - Still Sound 
TTC - De pauvres riches 
Turin Brakes - State Of Things 
Twin Shadow - Slow 
Two Door Cinema Club - I Can Talk 
Ty Segall, White Fence - I Am Not A Game 
Uffie - Pop The Glock 
UGK - Front, Back And Side To Side 
Underworld - Born Slippy 
Vampire Weekend - Cape Cod Kwassa Kwassa
Washed Out - Eyes Be Closed 
Ween - The Mollusk 
WU LYF - We Bros 
Yelle - Je veux te voir 
Big Brother And the Holding Company, Janis Joplin - Summertime 
Eminem - The Real Slim Shady 
Gil Scott-Heron - The Revolution Will Not Be Televised 
Can - Mother Sky 
Jonathan Richman, The Modern Lovers - Ice Cream Man 
Public Enemy - Louder Than A Bomb 
James Brown - Bodyheat 
Fugazi - Repeater 
John Coltrane - My Favourite Things 
Jeff Buckley - Dream Brother 
Funkadelic - One Nation Under A Groove 
Stevie Wonder - Sir Duke 
Michael Jackson - Billie Jean 
Al Green - Take Me To The River 
The Ramones - Blitzkrieg Bop 
Chic - Le Freak 
Elvis Presley - Blue Moon 
De La Soul, J Dilla - Stakes Is High 
Arctic Monkeys - When The Sun Goes Down
Sun Ra and his Myth Science Arkestra - Rocket Number Nine 
Primal Scream - Come Together 
Happy Mondays - Wrote For Luck 
The doors - Riders On The Storm 
The Who - I Can't Explain 
Tom Waits - In The Neighborhood 
The Fall - Totally Wired 
The Byrds - Eight Miles High 
Television - Marquee Moon 
Otis Redding - (Sittin' On) The Dock Of The Bay 
Johnny Cash - Folsom Prison Blues 
Underground Resistance - Jupiter Jazz 
Robert Johnson - Me And The Devil Blues 
Supreme NTM - Seine-Saint-Denis Style 
Etienne Daho - Duel au soleil 
The Notorious B.I.G. - Hypnotize 
Kate Bush - Wuthering Heights 
MGMT - Kids 
My Bloody Valentine - To Here Knows When 
Arcade Fire - Neon Bible 
Pulp - This Is Hardcore 
Sufjan Stevens - John Wayne Gacy, Jr. 
Portishead - Glory Box 
Bjork - Hunter 
Blondie - Atomic 
Patti Smith - Easter 
Elliott Smith - Between The Bars 
Depeche Mode - Enjoy The Silence 
Leonard Cohen - Lover Lover Lover 
Kanye West - Touch The Sky 
Felt - Primitive Painters 
Beastie Boys - Intergalactic 
N*E*R*D - Provider 
Prince - Pop Life 
Jay-Z - Dead Presidents II 
The Jesus And Mary Chain - Just Like Honey 
Fela Kuti - Zombie 
Massive Attack - Risingson 
Lou Reed - Coney Island Baby 
Led Zeppelin - When The Levee Breaks 
PJ Harvey - This Is Love 
Aphex Twin - Girl/Boy Song 
Pink Floyd - Lucifer Sam 
Frankie Knuckles - Your Love 
Blur - Song 2 
Brian Eno - An Ending (Ascent) 
Alain Bashung - Faites monter 
Jimi Hendrix - Voodoo Child (Slight Return) 
Sonic Youth - Silver Rocket 
The Libertines - Time For Heroes 
Sly And The Family Stone - Runnin' Away 
The White Stripes - Death Letter 
Nick Cave and the Bad Seeds - In The Ghetto 
The Cure - A Forest 
Radiohead - Karma Police 
Daft Punk - Around The World 
Marvin Gaye - What's Going On 
Neil Young - Down By The River 
Nick Drake - Cello Song 
The Sex Pistols - Anarchy In The U.K. 
Nas - N.Y. State Of Mind 
The Stooges - 1969 
The Strokes - Someday 
The Kinks - You Really Got Me 
Bob Dylan - A Hard Rain's A-Gonna Fall 
Missy Elliott - Get Ur Freak On 
N.W.A - Express Yourself 
Nirvana - Lithium 
The Stone Roses - I Am The Resurrection 
Talking Heads - Once In A Lifetime 
The Beatles - Tomorrow Never Knows 
Pixies - Debaser
The Rolling Stones - Gimme Shelter
The Beach Boys - God Only Knows
Serge Gainsbourg - Requiem pour un con
The Smiths - How Soon Is Now?
David Bowie - Heroes
The Clash - London Calling
Kraftwerk - Autobahn
The Velvet Underground - Venus in Furs
Joy Division - Love Will Tear Us Apart
