@{"upper":"false","parenthese":"false","removeAfter":"false","type":"SONG","separator":"-","artistFirst":"true","auteur":"Inrock","sorted":"false","size":"100","cat":"DECADE","rangeB":"2010","publish":"2019","name":"Inrock - Les 100 chansons font les années 2010 - 2019","reverseArtist":"false","create":"17/12/2019 22:05:42","rangeE":"2019"}
LCD Soundsystem - Drunk Girls
Blood Orange - Sutphin Boulevard
Frank Ocean - Thinkin Bout You
Daft Punk And Julian Casablancas - Instant Crush
FKA Twigs - Two Weeks
Tame Impala - Let It Happen
La Femme - Ou va le monde
Alex Cameron - Candy May
Flavien Berger - Brutalisme
Weyes Blood - Everyday
Arcade Fire - The Suburbs
Lana Del Rey - Video Games
Mac DeMarco - Ode to Viceroy
Arcade Fire - Afterlife
Fat White Family - Touch the Leather
Fishbach - Mortel
David Bowie - Blackstar
Migos - T-Shirt
Courtney Barnett - Need a Little Time
Tyler, the Creator - I THINK
The Drums - Let's Go Surfing
The Black Keys - Lonely Boy
Lescop - La foret
Solange - Losing You
Ariel Pink - Black Ballerina
PNL - Le monde ou rien
Kanye West - Ultralight Beam
Juliette Armanet - A la Folie
IDLES - Never Fight a Man with a Perm
Fat White Family - Tastes Good with the Money
Deerhunter - Desire Lines
Wu Lyf - Spitting Blood
Spiritualized - Hey Jane
Jagwar Ma - The Throw
Ty Segall - Manipulator
Kendrick Lamar - King Kunta
Weyes Blood - Do You Need My Love
Myth Syzer - Le code
Rosalia - Malamente
Kompromat - Niemand
Gil Scott-Heron - Me and the Devil
AsAP Rocky - Purple Swag
Zombie Zombie - Rocket #9
Phoenix - Trying to Be Cool
The Voidz - Human Sadness
Rihanna - Bitch Better Have My Money
Parquet Courts - Human Performance
Shame - Tasteless
Christine and the Queens - La marcheuse
Aldous Harding - The Barrel
Arnaud Fleurent-Didier - France culture
Frank Ocean - Novacane
Sky Ferreira - Everything Is Embarrassing
Major Lazer - Get Free
Caribou - Can't Do Without You
Beach House - Space Song
Agar Agar - Prettiest Virgin
Charlotte Gainsbourg - Kate
Clara Luciani - La grenade
Purple Mountains - That's Just the Way That I Feel
The Black Keys - Tighten Up
The Rapture - In the Grace of Your Love
Palma Violets - Best of Friends
The Knife - Full of Fire
Christine and the Queens - Christine
Young Thug - With That
Leonard Cohen - You Want It Darker
Orelsan - Basique
Father John Misty - God's Favorite Customer
SebastiAn and Sparks - Handcuffed to a Parking Meter
Bonnie "Prince" Billy - Go Folks, Go
Justice - Audio, Video, Disco
Hot Chip - Flutes
Arctic Monkeys - Do I Wanna Know?
Real Estate - Primitive
Preoccupations - Continental Shelf
PJ Harvey - The Wheel
Bjork and Arca - Tabula Rasa
Snail Mail - Speaking Terms
Iggy Pop - Sonali
Gorillaz - On Melancholy Hill
Connan Mockasin - Faking Jazz Together
Grimes - Oblivion
The Strikes - One Way Trigger
Jungle - Busy Earnin'
Drake - Hotline Bling
Parcels - Gamesofluck
Superorganism - Something for Your M.I.N.D.
Sheck Wes - Mo Bamba
Kim Gordon - Air BNB
Adam Green - Buddy Bradley
James Blake - Unluck
M.I.A. - Bad Girls
David Bowie - Where Are We Now?
Francois and the Atlas Mountains - La fille aux cheveux de soie
Kurt Vile - Pretty Pimpin
Beyonce - Formation
Future - Mask Off
Perez - La salle de bain
Hubert Lenoir - Fille de personne II
