#2003-2006

R. Kelly - Ignition (Remix)
Beyonce - Crazy In Love
!!! - Me and Giuliani Down by the School Yard (A True Story)
Devendra Banhart - A Sight to Behold
Joanna Newsom - Peach, Plum, Pear
Sufjan Stevens - Casimir Pulaski Day
Antony and the Johnsons - Hope There's Someone
The Books - Take Time
The Postal Service - Such Great Heights
Annie - Heartbeat
The Fiery Furnaces - Here Comes the Summer
The Mountain Goats - No Children
The Wrens - She Sends Kisses
Les Savy Fav - The Sweat Descends
Ted Leo and the Pharmacists - Where Have All the Rude Boys Gone?
The Exploding Hearts - Modern Kicks
Art Brut - Formed a Band
Boris - Farewell
Mastodon - Sleeping Giant
Madvillain - America's Most Blunted
T.I. - What You Know
Kelly Clarkson - Since U Been Gone
Amerie - 1 Thing
Ciara - Oh
Wolf Parade - I'll Believe in Anything
The Hold Steady - Stuck Between Stations
Beirut - Postcards from Italy
Johnny Boy - You Are the Generation That Bought More Shoes and You Get What You Deserve
Love Is All - Busy Doing Nothing
Jens Lekman - Black Cab
Christian Falk - Dream On
Justice vs. Simian - We Are Your Friends
Black Dice - Cone Toaster