@{"upper":"false","parenthese":"false","removeAfter":"false","type":"SONG","separator":"-","artistFirst":"true","auteur":"Divers","sorted":"false","size":"160","cat":"GENRE","rangeB":"0","publish":"2018","name":"Rock and Roll Hall of Fame - 160 Additional Songs - 2018","reverseArtist":"false","create":"25/06/2018 16:11:38","rangeE":"2018"}
Average White Band - Pick Up the Pieces 
Bauhaus - Bela Lugosi's Dead 
The Beastie Boys - Hey Ladies 
The Beatles - In My Life 
Chuck Berry - Brown Eyed Handsome Man 
Chuck Berry - Roll Over Beethoven 
Black Flag - T.V. Party 
David Bowie - Changes 
Jackie Brenston and His Delta Cats - Rocket 88 
James Brown - Sex Machine 
Jerry Butler and the Impressions - For Your Precious Love 
Buzzcocks - Fallin' In Love 
Leroy Carr - How Long How Long Blues 
The Carter Family - Keep On the Sunny Side 
The Chantels - Maybe 
Ray Charles - I Can't Stop Lovin' You 
The Chi-Lites - Have You Seen Her 
Chic - Good Times 
The Chords - Sh-Boom 
Eric Clapton - Tears In Heaven 
The Clash - White Man in Hammersmith Palais 
Patsy Cline - Walkin' After Midnight 
George Clinton - Atomic Dog 
Cocteau Twins - Ivo 
Leonard Cohen - Suzanne 
Coldplay - Yellow 
Nat “King” Cole - Straighten Up and Fly Right 
Lyn Collins - Think 
Elvis Costello And the Attractions - (What's So Funny 'Bout) Peace Love and Understanding) 
The Cure - In Between Days 
Bobby Darin - Mack the Knife 
The Dead Boys - Sonic Reducer 
The Dead Kennedys - Holiday in Cambodia 
Desmond Dekker And the Aces - Isrealites 
Depeche Mode - People Are People 
Bo Diddley - Say Man 
Dion - Runaround Sue 
The Doobie Brothers - What a Fool Believes 
The Drifters - On Broadway 
Earth Wind and Fire - Shining Star 
Missy "Misdemeanor" Elliott - Get Ur Freak On 
Eminem - Stan 
English Beat - Mirror in the Bathroom 
Everly Brothers - Wake Up Little Susie N
The "5" Royales - Think 
Fatboy Slim - Rockafeller Skank 
Aretha Franklin - (You Make Me Feel Like) Natural Woman 
The Fugees - Ready or Not 
Peter Gabriel - In Your Eyes 
Gang of Four - What We All Want 
Genesis - The Lamb Lies Down on Broadway 
Georgia Tom / Tampa Red - It's Tight Like That 
Geto Boys - Mind Playing Tricks On Me 
Gnarls Barkley - Crazy 
Green Day - Basket Case 
Hall and Oates - She's Gone 
Lionel Hampton - Flying Home 
P.J. Harvey - Dress 
Isaac Hayes - Theme from Shaft 
Heart - Barracuda 
The Jimi Hendrix Experience - Little Wing 
Billie Holiday - Strange Fruit 
Janet Jackson - Control 
The Jam - In the City 
Etta James - At Last 
Etta James - The Wallflower 
Tommy James And The Shondells - Crimson And Clover 
Jay-Z - Hard Knock Life (Ghetto Anthem) 
Billy Joel - Piano Man 
Judas Priest - Breaking the Law 
B.B. King - Three O'Clock 
Saunders King - S.K. Blues 
King Crimson - Court of the Crimson King 
The Kinks - Waterloo Sunset 
Korn - Freak on a Leash 
The La's - There She Goes 
Led Zeppelin - Kashmir 
Joe Liggins - The Honeydripper 
Professor Longhair - Mardi Gras in New Orleans 
Lene Lovich - Lucky Number 
Nick Lowe - Heart of the City 
Lynyrd Skynyrd - Sweet Home Alabama 
Madonna - Vogue 
Bob Marley and the Wailers - Redemption Song 
Bob Marley and the Wailers - Three Little Birds 
Dave Matthews Band - Ants Marching 
Stick McGhee - Drinkin' Wine Spo-Dee-O-Dee 
John Cougar Mellencamp - Pink Houses 
Miami Sound Machine - Conga 
Amos Milburn - Chicken Shack Boogie 
Lucky Millender - Who Threw the Whiskey in the Well 
Ministry - Stigmata 
The Miracles - Shop Around 
Moby - Porcelain 
Bill Monroe - Blue Moon of Kentucky 
Wild Bill Moore - Rock and Roll 
Alanis Morrisette - You Oughta Know 
My Chemical Romance - Welcome to the Black Parade 
N.W.A. - Fuck tha Police 
Naughty by Nature - O.P.P. 
New Order - Blue Monday 
Nine Inch Nails - Head Like a Hole 
Nirvana - All Apologies 
Oasis - Wonderwall 
Roy Orbison - Only the Lonely 
Ozzy Osborne - Crazy Train 
OutKast - Hey Ya! 
Pere Ubu - Final Solution 
Phish - Chalk Dust Torture 
The Pixies - Where Is My Mind? 
Elvis Presley - Hound Dog 
Jimmy Preston - Rock this Joint 
Prince and the Revolution - Purple Rain 
Prince - Sign o' the Times 
Queen - We Will Rock You 
Radiohead - Karma Police 
Ramones - Blitzkrieg Bop 
Johnnie Ray - Cry 
The Replacements - Here Comes a Regular 
The Rolling Stones - Paint It Black 
The Rolling Stones - Wild Horses 
The Runaways - Cherry Bomb 
Salt-n-Pepa - Let's Talk About Sex 
Arkie Shibley - Hot Rod Race 
Siouxie and the Banshees - Cities In Dust 
The Skatalites - Guns of Navarrone 
Little Millie Small - My Boy Lollipop 
Arthur Smith - Guitar Boogie 
Mamie Smith - Crazy Blues 
Patti Smith Group - Dancing Barefoot 
Trixie Smith - My Man Rocks Me (With One Steady Roll) 
The Smiths - How Soon Is Now 
The Specials - Ghost Town 
Dusty Springfield - Wishin' and Hopin' 
Bruce Springsteen - Born In the USA 
Bruce Springsteen - Streets of Philadelphia 
The Staple Singers - I'll Take You There 
Strafe - Set It Off 
Talking Heads - Psycho Killer 
2pac and Dr. Dre - California Love 
2pac - Me Against the World (or Keep Ya Head Up) 
Big Joe Turner - Roll Em Pete 
Tina Turner - What's Love Got to Do with It 
The Turtles - Happy Together 
U2 - One 
The Undertones - Teenage Kicks 
Velvet Underground - Sweet Jane 
Tom Waits - Hang on St. Christopher 
War - Low Rider 
Dionne Warwick - Walk On By 
Weezer - Undone (The Sweater Song) 
The Who - I Can See for Miles 
Hank Williams - Lovesick Blues 
Hank Williams - Movin' On Over 
Bob Wills and His Texas Playboys - Ida Red 
Jackie Wilson - Lonely Teardrops 
Little Stevie Wonder - Fingertips 
Frank Zappa - Montana 
ZZ Top - La Grange 
The Zombies - Time of the Season 
