Chicago - Beginnings
Tom Petty And the Heartbreakers - I Need to Know
Led Zeppelin - D'yer Mak'er
John Mayer - Covered in Rain
George Harrison - Got my Mind Set on You
Dave Matthews Band - Satellite
Marvin Gaye - Ain't That Peculiar
Howie Day - Morning After
Tom Petty - Square One
Todd Rundgren - I Saw the Light
Jackson Browne - Doctor My Eyes
Otis Redding - Hard to Handle
Elvis Presley - Heartbreak Hotel
Barbara Lewis - Hello Stranger
The Rascals - I Ain't Gonna Eat Out My Heart Anymore
Creedence Clearwater Revival - Have You Ever Seen the Rain
Led Zeppelin - Houses of the Holy
The Spinners - I'll Be Around
Fleetwood Mac - Everywhere
Tom Petty And the Heartbreakers - Breakdown
The Who - Postcard
Radiohead - Weird Fishes/Arpeggi
Bob Dylan - I Threw it All Away
John Lennon - Watching the Wheels
Pete Yorn - For Us
Buddy Holly - It Doesn't Matter Anymore
The Guess Who - Undun
Ray LaMontagne - Forever My Friend
Frank Sinatra - Glad to Be Unhappy
Lou Reed - Vicious
Tom Petty - You Don't Know How it Feels
Amos Lee - Seen it All Before
Frank Sinatra - Summer Wind
Cher - If I Could Turn Back Time
The National - Secret Meeting
Pharrell - Frontin'
Lovin' Spoonful - Summer in the City
The Band - Up on Cripple Creek
Chet Baker - Let's Get Lost
Etta James - Sunday Kind of Love
John Frusciante - Song to Sing When I'm Lonely
Ari Hest - Sleep Tonight
Hall And Oates- I Can't Go For That (No Can Do) 