#1950:
ELVIS PRESLEY - THE SUN SESSIONS
Various Artist - Anthology Of American Folk Music
Bo Diddley - Bo Diddley
Joao Gilberto - Chega De Saudade
Ray Charles - The Genius Of Ray Charles

#1960:
JAMES BROWN - LIVE AT THE APOLLO
BOB DYLAN - BRINGING IT ALL BACK HOME
THE ROLLING STONES - (I CAN'T GET NO) SATISFACTION
THE BEACH BOYS - PET SOUNDS
THE BEATLES - REVOLVER
JIMI HENDRIX - ARE YOU EXPERIENCED
THE VELVET UNDERGROUND & NICO - THE VELVET UNDERGROUND & NICO
LED ZEPPELIN - LED ZEPPELIN
THE STOOGES - THE STOOGES
SCOTT WALKER - SCOTT 4

John Coltrane - A Love Supreme
Love - Forever Changes
Fred Neil - Fred Neil
Ike & Tina Turner - River Deep Mountain High
Frank Zappa - Freak Out!
The Doors - The Doors
Pierre Henry & Michel Colombier - Messe Pour Le Temps Présent
Leonard Cohen - Songs Of Leonard Cohen
Dr. John - Gris-Gris
Nancy Sinatra & Lee Hazlewood - Nancy & Lee
The Kinks - The Village Green Preservation Society
Ennio Morricone - Il était une fois dans l'ouest
Silver Apples - Silver Apples
Tropicalia - Ou Panis Et Circensis
Captain Beefheart - Trout Mask Replica
Nick Drake - Five Leaves Left
Fairport Convention - Liege & Lief
Isaac Hayes - Hot Buttered Soul
King Crimson - In The Court Of The Crimson King
MC5 - Kick Out The Jams
Moondog - Moondog

#1970:
SERGE GAINSBOURG - HISTOIRE DE MELODY NELSON
MARVIN GAYE - WHAT'S GOING ON
SLY & THE FAMILY STONE - THERE'S A RIOT GOIN' ON
DAVID BOWIE - THE RISE AND FALL OF ZIGGY STARDUST...
ROXY MUSIC - ROXY MUSIC
CAN - FUTURE DAYS
BOB MARLEY & THE WAILERS - CATCH A FIRE
KRAFTWERK - AUTOBAHN
PATTI SMITH - HORSES
FLEETWOOD MAC - RUMOURS
SEX PISTOLS - NEVER MIND THE BOLLOCKS, HERE'S...
SUICIDE - SUICIDE
SUN RA - DISCO 3000
THE CLASH - LONDON CALLING
JOY DIVISION - UNKNOWN PLEASURES

Syd Barrett - The Madcap Laughs
Miles Davis - Bitches Brew
The Last Poets - The Last Poets
Gérard Manset - La Mort D'Orion
Curtis Mayfield - Curtis!
Black Sabbath - Master Of Reality
Creedence Clearwater Revival - Cosmo's Factory
Carole King - Tapestry
Joni Mitchell - Blue
Michel Polnareff - Polnareff's
T-Rex - Electric Warrior
Big Star - 1st record
Nuggets - Original Artyfacts From The First Psychedelic Era, 1965-1968
Lou Reed - Transformer
Todd Rundgren - Something/Anything
Gil Scott-Heron - Small Talk At 125th And Lenox
Archie Shepp - Attica Blues
Neil Young - Harvest
Al Green - Call Me
Elton John - Goodbye Yellow Brick Road
New York Dolls - New York Dolls
Pink Floyd - Dark Side Of The Moon
Stevie Wonder - Innervisions
King Tubby - Dub From The Roots
Steely Dan - Pretzel Logic
Robert Wyatt - Rock Bottom
Bruce Springsteen - Born To Run
AC/DC - High Voltage
Fela And Africa 70 - Zombie
Ramones - Ramones
The Congos - Heart Of The Congos
Various Artist - No New York
Television - Marquee Moon
Throbbing Gristle - The Second Annual Report Of T.G.
Wire - Pink Flag
Blondie - Parallel Lines
Buggles - Video Killed The Radio Star
Funkadelic - One Nation Under A Groove
The Human League - Travelogue
Gang Of Four - Entertainment!
Public Image Ltd - Metal Box

#1980:
TALKING HEADS - REMAIN IN LIGHT
THE CURE - PORNOGRAPHY
MICHAEL JACKSON - THRILLER
PRINCE - SIGN 'O' THE TIMES
U2 - THE JOSHUA TREE
PUBLIC ENEMY - IT TAKES A NATION OF MILLIONS...
THE STONE ROSES - THE STONE ROSES

David Byrne & Brian Eno - My Life In The Bush Of Ghosts
Métal Urbain - Les Hommes Morts Sont Dangereux
Young Marble Giants - Collosal Youth
Depeche Mode - Speak & Spell
Alain Bashung - Play Blessures
XTC - English Settlement
R.E.M. - Murmur
Husker Du - Zen Arcade
Madonna - Like A Virgin
Kate Bush - Hounds Of Love
The Jesus & Mary Chain - Psychocandy
Les Rita Mitsouko - The No Comprendo
Bad Brains - I Against I
Arthur Russell - Let's Go Swimming
N.W.A. - Straight Outta Compton
Sonic Youth - Daydream Nation
De La Soul - Three Feet High And Rising
Mano Negra - Puta's Fever
Pixies - Doolittle

#1990:
MASSIVE ATTACK - BLUE LINES
NIRVANA - NEVERMIND
SLINT - SPIDERLAND
BEASTIE BOYS - CHECK YOUR HEAD
DR. DRE - THE CHRONIC
NOIR DESIR - TOSTAKY
DAFT PUNK - HOMEWORK

Fugazi - Repeater
Various Artist - Rapattitude
My Bloody Valentine - Loveless
Talk Talk - Laughing Stock
Dominique A - La Fossette
PJ Harvey - Dry
Pavement - Slanted And Enchanted
Palace Brothers - There's No One What Will Take Care Of You
Wu-Tang Clan - Enter The Wu-Tang (36 Chambers)
Blur - Parklife
Jeff Buckley - Grace
Portishead - Dummy
The Prodigy - Music For The Jilted Generation
Basic Channel - Basic Channel
The Chemical Brothers - Exit Planet Dust
Miossec - Boire
Radiohead - The Bends
Aphex Twin - Richard D. James Album
DJ Shadow - Endtroducing...
Bjork - Homogenic
Carl Craig - More Songs About Food And Revolutionary Art
Missy Elliott - Supa Dupa Fly
Elliott Smith - Either/Or
Air - Moon Safari
Boards Of Canada - Music Has The Right To Children
Plastikman - Consumed
Anticon - Music For The Advencement Of Hip-Hop

#2000:
OUTKAST - STANKONIA
THE STROKES - IS THIS IT

Godspeed You! Black Emperor - Lift Your Skinny Fists...
Diplo - Florida
LCD Soundsystem - Losing My Edge
The Libertines - Up The Bracket
N.E.R.D. - In Search Of...
The Streets - Original Pirate Material
The White Stripes - Elephant
Arcade Fire - Funeral
Sufjan Stevens - Illinoise
Burial - Untrue