@{"upper":"false","parenthese":"false","removeAfter":"false","type":"ALBUM","separator":"-","artistFirst":"true","auteur":"Q","sorted":"false","size":"50","cat":"GENRE","rangeB":"0","publish":"2001","name":"Q - 50 Heaviest Albums Of All Time - 2001","reverseArtist":"false","create":"28/08/2018 11:53:34","rangeE":"2001"}
#As published in Q magazine July 2001
#In Alphabetical Order

AC/DC - Let There Be Rock
Aphex Twin - Classics
Big Black - Atomizer
The Birthday Party - Junkyard
Black Sabbath - Master Of Reality
Miles Davis - Dark Magus: Live At Carnegie Hall
Deep Purple - Machine Head
DJ6666 - Death Breathin'
Einsturzende Neubauten - Halber Mensch
Godspeed You Black Emperor - Levez Voz Skinny Fists Comme Antennas To Heaven
Guns N' Roses - Appetite For Destruction
Iron Maiden - The Number Of The Beast
The Jesus And Mary Chain - Psychocandy
Robert Johnson - King Of The Delta Blues Singers
Killing Joke - Killing Joke
King Crimson - Red
Korn - Korn
Kyuss - Blues For The Red Sun
Led Zeppelin - Physical Graffiti
Manic Street Preachers - The Holy Bible
Marilin Manson - Antichrist Superstar
Mayhem - Deathcrush
Mc5 - Kick Out The Jams
Metallica - Master Of Puppets
Method Man - Tical
Ministry - Psalm 69
Mob Deep - Hell On Earth
Motorhead - Overkill
My Bloody Valentine - Isn't Anything
Napalm Death - From Enslavement To Obliteration
Nine Inch Nales - The Downward Spiral
Nirvana - In Utero
Pantera - Vulgar Display Of Power
Pixies - Surfer Rosa
Primal Scream - Xtrmntr
Public Image Limited - Metal Box
Rage Against The Machine - Rage Againsed The Machine
Scarface - The Diary
Sepultura - Roots
Slayer - Reign In Blood
Slipknot - Slipknot
Sonic Youth - Evol
Soundgarden - Louder Than Love
Suicide - Suicide
Swans - Cop
The Stooges - Fun House
Tricky - Pre-Millennium Tention
Various - Natural Born Killers OST
Venom - Welcome To Hell
Neil Young And Crazy Horse - Weld 
