#Sections in chronological order of recording, with one main/essential track at the end. (Indicated here with a ) 
#Further Listening selections (which are not included in the ‘50’) don’t give dates or details, but they are alsin chronological order.

#Prehistoric Punks: 1955-1967

Phantom, the – Love Me
Maltais, Gene – Raging Sea
Wray, Link – Jack the Ripper
Adkins, Hasel – She Said
Sonics – Pyscho
Alvey, Randy & the Green Fuz – Green Fuz
Count Five – Psychotic Reaction
13th Floor Elevators – You’re Gonna Miss Me
Love – 7 & 7 Is

Seeds – Pushin’ ToHard

#Further Listening

Outcasts – 1523 Blair
Swamp Rats – Louie Louie
? & the Mysterians – 96 Tears
Music Machine – Talk Talk
Sons of Adam – Baby Show the World
Standells – Dirty Water
Nobody’s Children – Good Times
Zakary Thaks – Bad Girl
Other Half – Mr Pharmacist
Rocky & Riddlers – Flash & Crash
Fuller, Bobby Four – I Fought the Law
Monks – I Hate You

#Down on the Street: 1968-1978

Dictators – Next Big Thing
Television – Little Johnny Jewel
Electric Eels – Agitated
Germs – Forming
Misfits – Attitude

Dead Boys – Sonic Reducer

#Further Listening

Flamin’ Groovies – Teenage Head
Richman, Jonathan [Modern Lovers] – Road Runner
Rocket from the Tombs – Ain’t It Fun
Thunders, Johnny & the Heartbreakers – Chinese Rocks
X – We’re Desperate
Eyes – Don’t Talk tMe
Weirdos – Destroy All Music
Pere Ubu – 30 Seconds Over Tokyo
County, Jayne – If You Don’t Want tFuck Me, Fuck Off
Zeros – Wild Weekend
Dils – I Hate the Rich
Suicide – Ghost Rider
Crime – Hotwire My Heart

#Going Underground: 1978-1983

Black Flag – Nervous Breakdown
Dead Kennedys – California Über Alles
Dickies – Banana Splits (Tra La La Song)
Bad Brains – Pay tCum
Adolescents – Amoeba
Cramps – Garbage Man
Gun Club – She’s Like Heroin TMe
Flipper – Sex Bomb
Descendents – I’m Not a Loser
Fear – Let’s Have a War
Hüsker Dü – Everything Falls Apart

Minor Threat – I Don’t Wanna Hear It

#Further Listening

Plugz – La Bamba
Skulls – Building Models
Dicks – Hate the Police
Geza X – Mean Mr Mommy Man
Rik L Rick with Negative Trend – Mercenaries
TSOL – Abolish Government
Black Randy & the MetrSquad – I Slept in an Arcade
Circle Jerks – Group Sex
Big Boys – TV
Social Distortion – Another State of Mind
Suicidal Tendencies - Institutionalised

#Every Losers Wins: 1984-2005

Agnostic Front – Your Mistake
Minutemen – Political Song for Michael Jackson tSing
Sonic Youth – Death Valley ‘69
Lemonheads – Second Chance
Bad Religion – You Are (the Government)
Nirvana – Sliver
NOFX – Don’t Call Me White
At the Drive In – One Armed Scissor
Blood Brothers – Cecilia & the Silhouette Saloon

Mudhony – Touch Me I’m Sick

#Further Listening

Big Black – Kerosene
Butthole Surfers – Lady Sniff
Pussy Galore – Pretty Fuck Look
Scratch Acid – Mary Had a Little Drug Problem
Youth of Today – NMore
Fugazi – Margin Walker
Jesus Lizard – Gladiator
Bikini Kill – Rebel Girl
Rancid – Timebomb
Bronx, the – White Tar
Hot Snakes – Brain Trust
Sleater Kinney – Entertain