@{"upper":"false","parenthese":"false","removeAfter":"false","type":"SONG","separator":"-","artistFirst":"true","auteur":"Mojo","sorted":"false","size":"100","cat":"GENRE","rangeB":"0","publish":"0","name":"Mojo's 100 Greatest Psychedelic Classics","reverseArtist":"false","create":"02/07/2017 07:08:56","rangeE":"0"}
1966

The Charlatans - Alabama Bound
Bob Dylan - Visions Of Johanna
Jefferson Airplane - Blues From An Airplain
Country Joe And The Fish - Section 43
The Great Society - Someone To Love
Oxford Circle - Foolish Woman
Vijtables - Feel The Music
The 13th Floor Elevators - Roller Coaster
The Count Five - Psychotic Reaction
The Misunderstood - Children Of The Sun
Sons Of Adam - Feathered Fish
Love - 7 And 7 Is

1967

Sopwith Camel - Frantic Desolation
The Seeds - Mr Farmer
Kaleidoscope - Keep Your Mind Open
The Electric Prunes - Get Me To The World On Time
Mystery Trend - Johnny Was A Good Boy
Moby Grape - Omaha
Tim Buckley - Hallucinations
Chocolate Watch Band - Are You Gonna Be There? (At The Love In)
Big Brother Holding Company - Ball And Chain
Third Bardo - I'm Five Years Ahead Of My Time
Painted Faces - Anxious Color
The Beau Brummels - Magic Hollow
Buffalo Springfield - Broken Arrow
Strawberry Alarm Clock - Incense And Peppermints
Love - The Red Telephone
The Byrds - Change Is Now

1968

Otis Redding - (Sittin' On) The Dock Of The Bay
The Balloon Farm - A Question Of Temperature
Sly And The Family Stone - Dance To The Music
Quick Silver Messenger Service - Pride Of Man
The Grateful Dead - That's It For The Other One
The Steve Miller Band - Song For Ancestors
Lother And The Hand People - Machines
Tommy James And The Shondells - Crimson And Clover

1969

White Lightning - William
Sprit - Dream Within A Dream
Alexander Skip Spence - War In Peace
The Youngbloods - Darkness, Darkness
Kak - Electric Sailor
The Grateful Dead - Mountains Of The Moon
Jimi Hendrix - Star-spangled Banner

#Psychedelia UK

1966

The Creation - Making Time
The Yardbirds - Happenings Ten Years Time Ago
Cream - I Feel Free

1967

Pink Floyd - Interstellar Overdrive
Smoke - My Friend Jack
David Mcwilliams - Days Of Pearly Spencer
The Poets - In Your Tower
The Small Faces - Green Circles
The Move - I Can Hear The Grass Grow
The Troggs - Night Of The Long Grass
Traffic - Paper Sun
The Jimi Hendrix Experience - Are You Experienced?
John's Children - Midsummer Night Dream
The Beatles - It's All To Much
The Attack - Colours Of My Mind
The Rolling Stones - We Love You
The Jimi Hendrix Experience - The Stars That Play With Laughing Sam's Dice
Pink Floyd - Matilda Mother
The Who - Relax
Kaleidoscope - Flight From Ashiya
The Pretty Things - Defecting Grey
The Herd - From The Underworld
The 23rd Turnoff - Michael Angelo
The Hollies - King Midas In Reverse
Svensk - Dream Magazine
The Idle Race - Impostors Of Life's Magazine
The Animals - San Franciscan Nights
The Troggs - Love Is All Around
Tintern Abbey - Vacuum Cleaner
Dantalian's Chariot - Madman Running Through The Fields
Simon Dupree And The Big Sound - Kites
Tomorrow - Revolution

1968

Fairport Convention - It's Alright Ma, It's Only Witchcraft
Status Quo - Pictures Of Matchstick Men
The Apple - The Otherside
The Mirror - Faster Than Light
Nirvana - Rainbow Chaser
Big Boy Pete - Cold Turkey
Family - Me My Friend
Pink Floyd - Jugland Blues
The Crazy World Of Arthur Brown - Fire
The Jimi Hendrix Experience - 1983..(A Merman I Should Turn To Be)
The Nice - Diamond Hard Blue Apples Of The Moon
10 Modern Day Classics - Andrew Harrison
Rhythim Is Rhythim - Nude Photo
Phuture - Acid Tracks
A Guy Called Gerald - Voodoo Ray
Swan Lake - In The Name Of Love
The Beastie Boys - Paul's Boutique
The Orb - A Huge Ever Growing Pulsating Brain That Rules From The Centre Of The Underworld
Beltram - Energy Flush
The Aphex Twin - Analogue Bubblebath Vol. I
Underworld - Cowgirl
The Chemical Brothers - The Private Psychedelic Reel
