1980

• Adam And The Ants – Kings Of The Wild Frontier
• The Cramps – Songs The Lord Taught Us
• Diana Ross – Diana
• Joy Division – Closer
• Linton Kwesi Johnson – Bass Culture
• AC/DC – Back In Black
• The Specials – More Specials
• The Jam – Sound Affects
• Dead Kennedy’s – Fresh Fruit For Rotting Vegetables
• David Bowie – Scary Monsters

Singles

• Stray Cats – Runaway Boys
• Martha And The Muffins – Echo Beach
• The Beat – Mirror In The Bathroom
• Stevie Wonder – Masterblaster
• Killing Joke - Wardance

1981

• Black Uhuru – Red
• Black Flag – Damaged
• The Teardrop Explodes – Kilimanjaro
• Orchestra Manoeuvres In The Dark – Architecture & Morality
• Brian Eno & David Byrne – My Life In The Bush Of Ghosts
• Japan – Tin Drum
• Kraftwerk – Computer World
• The Police – Ghost In The Machine
• Grace Jones – Nightclubbing
• Soft Cell – Non-Stop Erotic Cabaret

Singles

• Headgirl – St Valentine’s Day Massacre EP
• Ultravox – Vienna
• Madness – Grey Day
• Scritti Politti – The Sweetest Girl
• The Undertones – It’s Going To Happen

1982

• Siouxsie & The Banshees - A Kiss In The Dreamhouse
• Motorhead – No Sleep ‘Till Hammersmith
• Simple Minds – Sons And Fascination
• Iron Maiden – The Number Of The Beast
• Abc – The Lexicon Of Love
• Donald Fagen – The Nightfly
• Elvis Costello – Imperial Bedroom
• Richard & Linda Thompson – Shoot Out The Lights
• The Clash – Combat Rock

Singles

• Grandmaster Flash – The Message
• Joan Jett – I Love Rock ‘N’ Roll
• Africa Bambaataa – Planet Rock
• Daryl Hall & John Oats – Maneater
• Marvin Gaye – Sexual Healing


1983

• Orange Juice – You Can’t Hide Your Love Forever
• The Cure – Pornography
• The Birthday Party – Junkyard
• The The – Soul Mining
• Aztec Camera – High Land Hard Rain

Singles

• Michael Jackson – Billie Jean
• Wah! – The Story Of The Blues
• New Order – Blue Monday
• Elton John – I Guess That’s Why You Call It The Blues
• George Clinton – Atomic Dog


1984

• King Sunny Ade And His African Beats – Juju Music
• Aswad – Live And Direct
• Lloyd Cole And The Commotions – Rattlesnakes
• Bruce Springsteen – Born In The Usa
• Echo And The Bunnymen – Ocean Rain
• The Smiths – Hatful Of Hollow
• R.E.M. – Reckoning
• Youssou N’dour – Immigres
• Minutemen – Double Nickels On The Dime
• Cocteau Twins – Treasure

Singles

• Frankie Goes To Hollywood – Two Tribes
• Violent Femmes – Gone Daddy Gone
• Strawberry Switchblade – Since Yesterday
• Sade – Your Love Is King
• Chaka Khan – I Feel For You


1985

• Dexys Midnight Runners – Don’t Stand Me Down
• Husker Du – New Day Rising
• Prefab Sprout – Steve Mcqueen
• The Pogues – Rum, Sodomy And The Lash
• Kate Bush – Hounds Of Love
• The Jesus And Mary Chain – Psychocandy
• The Colourfield – Virgins And Philistines
• John Zorn – Spillane
• Tom Waits – Rain Dogs

Singles

• Madonna – Into The Groove
• Redskins – Bring It Down
• Pet Shop Boys – West End Girls
• The Style Council – Walls Come Tumbling Down
• Mighty Lemon Drops – Like An Angel


1986

• New Order – Low-Life
• Martin Stephenson & The Daintees – Boat To Boliva
• The Cult – Love
• The Fall – This Nation’s Saving Grace
• Big Black – Atomizer

Singles

• Housemartins – Happy Hour
• Run DMC & Aerosmith – Walk This Way
• Psychic Tv – Godstar
• Big Audio Dynamite – E=Mc2
• James Brown – Living In America


1987

• Le Mystere Des Voix Bulgares - Le Mystere Des Voix Bulgares
• Public Image Ltd – Album
• Metallica – Master Of Puppets
• Guns N’ Roses – Appetite For Destruction
• U2 – The Joshua Tree
• Prince – Sigh ‘O’ The Times

Singles

• Eric B And Rakim – I Know You Got Soul
• The Sugarcubes – Birthday
• M/A/R/R/S – Pump Up The Volume
• Beastie Boys – [You Gotta] Fight For Your Right [To Party]
• The La’s – Way Out


1988

• Happy Mondays – Bummed
• My Bloody Valentine – Isn’t Anything
• Steve Earle – Copperhead Road
• Sonic Youth – Daydream Nation
• The House Of Love – The House Of Love
• Mudhoney – Superfuzz Bigmuff
• Public Enemy – It Will Take A Nation Of Millions To Hold Us Back
• Luther Vandross – Any Love
• Talk Talk – Sprit Of Eden

Singles

• A Guy Called Gerald – Voodoo Ray
• Morrissey – Suedehead
• Guns ‘N’ Roses – Sweet Child O’ Mine
• Dinosaur Jr – Freak Scene
• The Wedding Present – Why Are You Being So Reasonable Now


1989

• N.W.A. – Straight Outta Compton
• Spaceman 3 – Playing With Fire
• De La Soul – 3 Feet High And Rising
• Soul II Soul – Club Classics Vol. One
• Bob Dylan – Oh Mercy
• The Stone Roses – The Stone Roses
• Pixies – Doolittle

Singles

• Joe Smooth – Promised Land
• Depeche Mode – Personal Jesus
• Kitchens Of Distinction – The 3rd Time We Opened The Capsule
• 808 State – Pacific State
• Neneh Cherry – Buffalo Stance