LCD Soundsystem - All My Friends
Wilco - Jesus, etc.
Arcade Fire - Neighborhood #1 (Tunnels)
Sigur Rós - Hoppípolla
Sufjan Stevens - The Predatory Wasp of The Palisades Is Out To Get Us
Radiohead - Idioteque
OutKast - B.O.B.
The Knife - Heartbeats
Iron And Wine - The Trapeze Swinger
The National - Mr. November
Daft Punk - Digital Love
Belle & Sebastian - I'm Waking Up To Us
Phoenix - Lisztomania
Wolf Parade - I'll Believe In Anything
The Flaming Lips - Do You Realize??
Kanye West - Jesus Walks
Band of Horses - The Funeral
Panda Bear - Bros
The Mountain Goats - No Children
The New Pornographers - The Bleeding Heart Show
Yo La Tengo - You Can Have It All
Andrew Bird - Tables and Chairs
Broken Social Scene - Cause = Time
of Montreal - The Past Is A Grotesque Animal
Fleet Foxes - White Winter Hymnal
UGK, OutKast - Int'l Players Anthem (I Choose You)
Spoon - Finer Feelings
M.I.A. - Paper Planes
Interpol - NYC
Bloc Party - This Modern Love
Gnarls Barkley - Crazy
Beirut - Postcards From Italy
The Decemberists - July, July!
TV On The Radio - Wolf Like Me
The Hold Steady - Stuck Between Stations
Stars - Elevator Love Letter
Animal Collective - My Girls
Jens Lekman - Black Cab
Modest Mouse - Gravity Rides Everything
Hot Chip - Ready For The Floor
The Postal Service - Such Great Heights
Sunset Rubdown, Spencer Krug of Wolf Parade - Shut Up I Am Dreaming Of Places Where Lovers Have Wings
Feist - Mushaboom
The White Stripes - Hotel Yorba
Okkervil River - For Real
Los Campesinos! - You! Me! Dancing!
Grizzly Bear - Two Weeks
The Walkmen - The Rat
Rilo Kiley - Spectacular Views
Explosions In The Sky - First Breath After Coma