J Cole - Be Free
Caribou - Silver
Tobias Jesso Jr - True Love
Perfume Genius - Grid
Owen Pallett - The Riverbed
D'Angelo and the Vanguard - Really Love
White Hinterland - Ring The Bell
Dog Day - Before Us
A. G. Cook - Beautiful
Nap Eyes - No Fear of Hellfire
E-40 - Choices (Yup)
Myriam Gendron - Threnody
Jennifer Lopez ft French Montana - I Luh Ya Papi
Homeboy Sandman ft J-Live and Kurious - Enough
Jessie Ware - Tough Love
Melanie De Biasio - The Flow
FKA Twigs - Pendulum
Sia - Eye of the Needle
Alvvays - Archie, Marry Me
Hannah Diamond - Every Night
Mary J Blige - Whole Damn Year
Astral Swans - You Carry A Sickness
Kiesza - Hideaway
Percussions - Sext (TEXT029B)
Miracle Fortress - Let Me Be The 1
Run the Jewels - Close Your Eyes (And Count to Fuck)
Michael Feuerstack And Associates ft Mathias Kom - Along the Way
Frankie Cosmos - Birthday Song
ILoveMakonnen ft Drake - Tuesday
Ought - Habit
Arlt And Thomas Bonvalet - Je voudrais être mariée
Spooky Black - Without U
Hundred Waters - Down From the Rafters
Thee Silver Mt Zion Memorial Orchestra - What We Loved Was Not Enough
La Roux - Let Me Down Gently
James Irwin - Everything Passed Me By
Don Jazzy, Tiwa Savage, Dr SID, D'Prince And The Mavins - Dorobucci
Nancy Pants - Happy
Deerhoof - Paradise Girls
Aunts - Sunsets
M.O. ft K Koke - For A Minute
Weaves - Shithole
AltJ - Lovely Day
GFOTY - Don't Wanna / Let's Do It
Bry Webb - AM Blues
Nick Jonas - Jealous
Future Islands - Seasons (Waiting For You)
PS I Love You - Friends Forever
Jones - You
Lil Wayne - D'usse
Ariel Pink - Put Your Number In My Phone
Jennifer Castle - How Or Why
Tinashe ft Schoolboy Q - 2 On
Eric Church - Give Me Back My Hometown
Wild Beasts - A Simple Beautiful Truth
QT - Het QT
The Barr Brothers - Even the Darkness Has Arms
Young Fathers - Get Up
Clap Your Hands Say Yeah - Coming Down
The War on Drugs - Red Eyes
Big Nuz - Incwadi Yothando
Parquet Courts - Ducking and Dodging
Tomas Bardfod ft Nina K - Pulsing
Kool A.D. ft Talib Kweli And Boots Riley - Hickory
Drive-By Truckers - Primer Coat
Andy Stott - Faith In Strangers
Charli XCX - Gold Coins
Bear In Heaven - Time Between
Doug Paisley - It's Not Too Late (To Say Goodbye)
Sharon Van Etten - Our Love
Prince - U Know
Mr Twin Sister - Crime Scene
BRONCHO - Class Historian
Hurray for the Riff Raff - The Body Electric
Lily Allen - Air Balloon
Drake - 0 to 100 / The Catch Up
Real Estate - Past Lives
Jason Derulo ft Snoop Dogg - Wiggle
Bleachers - I Wanna Get Better
LIVINGSTON - S/He Is Like the Angry Birds
Restorations - Separate Songs
Mark Berube - Carnival
Goat - Talk To God
Jessica Pratt - Back, Baby
Jonnie Common - Better Man
TOPS - Way to Be Loved
Taylor Swift - Clean
Guru - Pooley
Two White Cranes - Acraman's Road
Beck - Morning
Chad VanGaalen - Weighed Sin
Marianas Trench ft Anami Vice - Pop 101
Natalie Prass - Why Don't You Believe In Me
HAERTS - Giving Up
Wye Oak - Logic of Color
Orouni - Speedball
Lydia Ainsworth - White Shadows
Valery Gore - With The Future
Major Lazer ft Ariana Grande - All My Love
Aphex Twin - Aisatsana