1 a 100
Mbongwana Star - Malukayi
Skrillex and Diplo ft Justin Bieber - Where Are Ü Now
Majical Cloudz - Downtown
Erykah Badu - Hotline Bling (But U Cain't Use My Phone Mix)
Grimes - REALiTi (demo)
Fetty Wap - Trap Queen
Sheer Mag - What You Want
Fadimoutou Wallet Inamoud - Wana Le Nouveau
Carly Rae Jepsen - Run Away With Me
Shura - Touch
Michael Feuerstack - Clackity Clack
Dilly Dally - Desire
Kendrick Lamar - The Blacker The Berry
Young Galaxy - Body
CHVRCHES - Empty Threat
Kiiara - Gold
José Gonzalez - Open Book
Justin Bieber - What Do You Mean?
Julia Holter - Feel You
Basia Bulat - Infamous
Dick Diver - Waste the Alphabet
Brandon Flowers - Between Me And You
Kurt Vile - Pretty Pimpin'
Rozi Plain - Actually
David Bowie - Blackstar
Unknown Mortal Orchestra - The World Is Crowded
Julien Baker - Something
This Is The Kit - Silver John
The Acorn - In Silence
Tirzah - Make It Up
Jamie xx - Gosh
Yo La Tengo - Before We Stopped To Think
Christine and the Queens - Saint Claude
All Dogs - That Kind of Girl
Demi Lovato - Confident
Janet Jackson - No Sleep
Receivers - Ships & Lanterns
Lady Leshurr - Queen's Speech 4
Ian William Craig - Either Or
Langhorne Slim & the Law - Wolves
Tame Impala - The Moment
Drake - Know Yourself
Low - What Part Of Me
Naytronix - Mister Divine
Destroyer - Times Square, Poison Season I
Young Fathers - Nest
Wolf Alice - Bros
Wilco - You Satellite
Olivare - When I Look Around
Alabama Shakes - Dunes
The Weather Station - Tapes
Lil Mama - Sausage
Sophie - VYZEE
Jessie Jones - Lady La De Da
D.R.A.M. - Cha Cha (original version)
Kehlani ft Coucheron - Alive
Georgia - Move Systems (Georgia vs Stella Mozgawa Drum Version)
Natalie Prass - My Baby Don't Understand Me
TUNS - Throw It All Away
Alessia Cara - Here
Arlt - Les oiseaux cassent
The Dream - Black Magic
The Wainwright Sisters - Lullaby
Weaves - Tick
Colin Stetson and Sarah Neufeld - The Rest Of Us
Enya - Echoes in the Rain
Wizkid ft Drake and Skepta - Ojuelegba (Remix)
Partner - Hot Knives
Michelle McAdorey - Two Tickets
Hop Along - Powerful Man
Yemi Alade ft Selebobo - Na Gode
Joanna Newsom - The Things I Say
Ariel Sharratt & Mathias Kom - Fuck the Government, I Love You
Carnage ft ILoveMakonnen - I Like Tuh
Katie Moore - Baby Can I Hold You
Deforesters - A Song for the Reptoids of Denver International Airport to Sing
Domenique Dumont - La Bataille de Neige
Bully - I Remember
Jamie Woon - Movement
Adele - When We Were Young
DeJ Loaf ft Big Sean - Back Up
Ought - Passionate Turn
ANOHNI - 4 Degrees
Quivers - Ridin' on the Hearses
OMI - Cheerleader (Felix Jaehn radio edit)
Petite Noir - Chess
Danny L Harle - Awake for Hours
The Adam Brown - Can't Sleep
Svantana - Workin' In A Cocktail Bar
The Weeknd - Often
Sufjan Stevens - All Of Me Wants All Of You
Beirut - Gibraltar
Ty Dollar Sign ft Charli XCX and Tinashe - Drop That Kitty
Deradoorian - A Beautiful Woman
Marie-Pierre Arthur - Rien à faire
Tori Kelly - Nobody Love
Coldplay - Birds
Mac Demarco - TheWay You'd Love Her
Cosmo Sheldrake ft Anndreyah Vargas - Rich
Jib Kidder - Appetites