@{"upper":"false","parenthese":"false","removeAfter":"false","type":"SONG","separator":"-","artistFirst":"true","auteur":"NME","sorted":"false","size":"50","cat":"YEAR","rangeB":"2003","publish":"2003","name":"NME - Tracks Of The Week - 2003","reverseArtist":"false","create":"04/09/2018 11:33:46","rangeE":"2003"}
Electric Six - Danger! High Voltage
The Eighties Matchbox B-Line Disaster - Psychosis Safari
Jay Z -'03 Bonny And Clyde
The Warlocks - Hurricane Heart Attack
The Datsuns - Harmonic Generator
Polyphonic Spree - Light And Day
The Hiss - Triumph
Junior Sensor - Move Your Feet
The Coral - Don't Think You're The First
50 Cent - In Da Club
Cabaret Voltaire - Nag Nag Nag
Hot Hot Heat - Bandages
Mew - Comforting Sounds
The Faint - Agenda Suicide
Blur - Out Of Time
The White Stripes - 7 Nation Army
Interpol - Say Hello To The Angels/Nyc
The Dandy Warhols - We Used To Be Friends
22-20s - Such A Fool
Stellastarr* - Somewhere Across Forever
Are Weapons - Hey World
Kinks Of Leon - What I Saw Ep
The Thrills - Big Sur
Colder - Shiny Star/The Slow Descent
Yeah Yeah Yeahs - Pin
50 Cent - 21 Questions
Beyonce And Jay-Z - Crazy In Love
Burning Brides - Arctic Snow
Thrice/Thursday - Under A Killing Moon/For The Workforce, Drowning
Hot Hot Heat - No Not Now
The Ravonettes - That Great Love Sound
Razorlight - Rock'N' Roll Lies
The Libertines - Don't Look Back Into The Sun
Grafiti - What Is The Problem?
Trash Money - You Lied Satan
Franz Ferdinhand - Darts Of Pleasure
Stellastar* - Jenny
Outkast - Ghetto Music
Chicks On Speed - We Don't Play Guitars
The Strokes - 12:15
50 Cent - Pimp
Chingy - Right Thurr
Eastern Lane - Feed Your Addiction
Desert Sessions - Crawl Home
Outkast - Hey Ya!
My Red Cell - My Red Cell Ep
The Rapture - Sister Saviour
The Ravonettes - Heartbreak Stroll/The Christmas Song
Selfish Cunts - Britain Is Shit/Fuck The Poor
The Darkness - Christmas Time (Don't Let The Bells End)
