Aimee Mann - Mental Illness
Akademie fur Alte Musik, Berlin - Telemann: Concerti per molti stromenti
Algiers - The Underside of Power
Alvvays - Antisocialites
Angaleena Presley - Wrangled
Ann Hallenberg / Il Pomo d'Oro - Carnevale 1729
Arca - Arca
Benjamin Booker - Witness
Bjork - Utopia
Bunbury - Expectativas
Cantica Symphonia / La Compagnia del Madrigale / Giuseppe Maletto / Ensemble La Pifarescha - Claudio Monteverdi: Vespro della Beata Vergine
Circuit des Yeux - Reaching for Indigo
Colleen - A Flame My Love, A Frequency
Converge - The Dusk in Us
Curtis Harding - Face Your Fear
Cecile McLorin Salvant - Dreams and Daggers
Depeche Mode - Spirit
Downtown Boys - Cost of Living
EMA - Exile in the Outer Ring
EX EYE - EX EYE
Fever Ray - Plunge
Fleet Foxes - Crack-Up
Francois-Xavier Roth / Les Siecles - Maurice Ravel: Daphnis And Chloe, Complete Ballet
Fred Thomas - Changer
Gas - Narkopop
Girl Ray - Earl Grey
Hurray for the Riff Raff - The Navigator
Idles - Brutalism
Jane Weaver - Modern Kosmology
JD McPherson - Undivided Heart And Soul
Jlin - Black Origami
Juana Molina - Halo
Kaitlyn Aurelia Smith / Stargaze - The Kid
Kehlani - SweetSexySavage
Kelela - Take Me Apart
Kendrick Lamar - DAMN.
King Krule - The Ooz
Kip Moore - Slowheart
La Santa Cecilia - Amar y Vivir
Laura Marling - Semper Femina
LCD Soundsystem - American Dream
Lorde - Melodrama
Lost Horizons - Ojala
Mac DeMarco - This Old Dog
Mastodon - Emperor of Sand
Max Richter - Max Richter: Three Worlds – Music from Woolf Works
Mount Eerie - A Crow Looked at Me
Nicole Atkins - Goodnight Rhonda Lee
Nicole Mitchell - Mandorla Awakening II: Emerging Worlds
Omni - Multi-Task
Paramore - After Laughter
Protomartyr - Relatives in Descent
Randy Newman - Dark Matter
Riccardo Muti / Chicago Symphony Orchestra - Bruckner: Symphony No. 9
Robert Plant - Carry Fire
Roscoe Mitchell - Bells for the South Side
Sacred Paws - Strike a Match
Sampha - Process
Sheer Mag - Need to Feel Your Love
Sherwood And Pinch - Man vs. Sofa
St. Vincent - Masseduction
Susanne Sundfør - Music for People in Trouble
SZA - Ctrl
The Clientele - Music for the Age of Miracles
The Moonlandingz - Interplanetary Class Classics
Tyler, The Creator - Flower Boy
Vijay Iyer / Vijay Iyer Sextet - Far from Over
Vince Staples - Big Fish Theory
Whitney Rose - Rule 62
Zara McFarlane - Arise
