Aaron Freeman - Freeman
Alvvays - Alvvays
Ana Tijoux - Vengo
Angaleena Presley - American Middle Class
Aphex Twin - Syro
Arca - Xen
Ben Frost - A U R O R A
Cloud Nothings - Here and Nowhere Else
Craig Handy - Craig Handy And 2nd Line Smith
Run the Jewels - Run the Jewels 2
EMA - The Future's Void
Ex Hex - Rips
FKA twigs - LP1
Flying Lotus - You're Dead!
Future Islands - Singles
Gustavo Dudamel And Simon Bolivar Symphony Orchestra of Venezuela - Mahler: Symphony No. 7
Jenny Lewis - The Voyager
Jesse Boykins III - Love Apparatus
Joyce Manor - Never Hungover Again
K. Michelle - Anybody Wanna Buy a Heart?
Kelis - Food
Kimbra - The Golden Echo
Lana Del Rey - Ultraviolence
Lee Ann Womack - The Way I'm Livin'
Liars - Mess
Little Dragon - Nabuma Rubberband
Mac DeMarco - Salad Days
Mahan Esfahani - Rameau: Pieces de clavecin
Miranda Lambert - Platinum
Moreno Veloso - Coisa Boa
Nothing - Guilty of Everything
Otis Brown III - The Thought of You
Perfume Genius - Too Bright
Protomartyr - Under Color of Official Right
Real Estate - Atlas
Robert Plant - lullaby and... The Ceaseless Roar
Shabazz Palaces - Lese Majesty
Toumani Diabate And Sidiki Diabate - Toumani And Sidiki
Sleaford Mods - Divide and Exit
St. Vincent - St. Vincent
Stephen Malkmus And The Jicks - Wig Out At Jagbags
Sturgill Simpson - Metamodern Sounds In Country Music
Takuya Kuroda - Rising Son
Temples - Sun Structures
Teyana Taylor - VII
The Bug - Angels And Devils
The War on Drugs - Lost in the Dream
Theo Croker - AfroPhysicist
Thomas Hampson And Wolfram Rieger - Songs By Richard Strauss, Notturno
Tune-Yards - Nikki Nack
