A Tribe Called Quest - We got it from Here... Thank You 4 Your service
Agnes Obel - Citizen of Glass
Alejandro Escovedo - Burn Something Beautiful
Amos Lee - Spirit
Anderson .Paak - Malibu
Andy Stott - Too Many Voices
Angel Olsen - My Woman
Astronoid - Air
Aubrie Sellers - New City Blues
Beyonce - Lemonade
Brandy Clark - Big Day in a Small Town
Car Seat Headrest - Teens of Denial
Chance The Rapper - Coloring Book
Charles Bradley - Changes
Danny Brown - Atrocity Exhibition
David Bowie - Blackstar
Donny McCaslin - Beyond Now
Drive-By Truckers - American Band
Esperanza Spalding - Emily's D+Evolution
Iggy Pop - Post Pop Depression
Johann Johannsson - Orphee
Jenny Hval - Blood Bitch
Jessy Lanza - Oh No
Kaitlyn Aurelia Smith - EARS
KAYTRANADA - 99.9%
Kendrick Lamar - untitled unmastered.
King - We Are King
King Gizzard and the Lizard Wizard - Nonagon Infinity
Kvelertak - Nattesferd
Kyle Dixon And Michael Stein - Stranger Things, Vol 1
Leonard Cohen - You Want It Darker
Maren Morris - Hero
Margo Price - Midwest Farmer's Daughter
Michael Spiro, Wayne Wallace And La Orquestra Sinfonietta - Canto America
Miranda Lambert - The Weight of These Wings
Mitski - Puberty 2
Nick Cave And The Bad Seeds - Skeleton Tree
Niki And The Dove - Everybody's Heart Is Broken Now
Omni - Deluxe
Paul Simon - Stranger to Stranger
Radiohead - A Moon Shaped Pool
Sarathy Korwar - Day to Day
Savages - Adore Life
Solange - A Seat at the Table
Sturgill Simpson - A Sailor's Guide to Earth
Tegan and Sara - Love You to Death
The Dear Hunter - Act V: Hymns With the Devil In Confessional
The Rolling Stones - Blue And Lonesome
William Tyler - Modern Country
Yussef Kamaal - Black Focus
