@{"upper":"false","parenthese":"false","removeAfter":"false","type":"ALBUM","separator":"-","artistFirst":"true","auteur":"AllMusic","sorted":"false","size":"60","cat":"YEAR","rangeB":"2018","publish":"2018","name":"AllMusic - Album - 2018","reverseArtist":"false","create":"18/12/2018 10:03:16","rangeE":"2018"}
Alejandro Escovedo - The Crossing
Alice Bag - Blueprint
Ariana Grande - Sweetener
Ashley Monroe - Sparrow
Autechre - NTS Sessions
Billy Gibbons - The Big Bad Blues
Blood Orange - Negro Swan
Brothers Osborne - Port Saint Joe
Carolyn Sampson / Joseph Middleton - A Soprano's Schubertiade
Christine and the Queens - Chris
Damien Jurado - The Horizon Just Laughed
Draco Rosa - Monte Sagrado
Field Music - Open Here
Fred Thomas - Aftering
Ghost - Prequelle
Gilbert O'Sullivan - Gilbert O'Sullivan
Gustavo Gimeno - Stravinsky: The Rite of Spring; Funeral Song; Game of Cards; Concerto in D "Basel"; Agon
I'm with Her - See You Around
Janelle Monae - Dirty Computer
John Prine - The Tree of Forgiveness
Jon Hopkins - Singularity
Julia Holter - Aviary
Kacey Musgraves - Golden Hour
Kadhja Bonet - Childqueen
Kali Uchis - Isolation
Kamasi Washington - Heaven And Earth
Kids See Ghosts - Kids See Ghosts
Lotic - Power
Low Cut Connie - Dirty Pictures, Pt. 2
Luluc - Sculptor
Magdalena Kozena / Robin Ticciati - Ravel, Duparc: Aimer et mourir, Danses et melodies
Makaya McCraven - Universal Beings
Marc Ribot - Songs of Resistance 1942-2018
Melody's Echo Chamber - Bon Voyage
Mitski - Be the Cowboy
Mount Eerie - Now Only
Nathan Salsburg - Third
Neko Case - Hell-On
Noname - Room 25
Old Crow Medicine Show - Volunteer
Oneohtrix Point Never - Age Of
Ovlov - Tru
Pistol Annies - Interstate Gospel
Robyn - Honey
Rolling Blackouts Coastal Fever - Hope Downs
Rosalia - El Mal Querer
Shopping - The Official Body
Shy Layers - Midnight Marker
Sons of Kemet - Your Queen Is a Reptile
Sophie - Oil of Every Pearl's Un-Insides
Superchunk - What a Time to Be Alive
Superorganism - Superorganism
;The Midnight Hour - The Midnight Hour
The Orielles - Silver Dollar Moment
Travis Scott - Astroworld
Viktoria Mullova / Paavo Jarvi - Arvo Part
Vince Staples - FM!
Virginia Wing - Ecstatic Arrow
Yamantaka // Sonic Titan - Dirt
YOB - Our Raw Heart
