@{"upper":"false","parenthese":"false","removeAfter":"false","type":"SONG","separator":"-","artistFirst":"true","auteur":"Rolling Stone","sorted":"false","size":"50","cat":"DECADE","rangeB":"2000","publish":"2010","name":"Rolling Stone - The Best Songs of the Decade - 00's - 2010","reverseArtist":"false","create":"07/09/2018 15:13:47","rangeE":"2009"}
Aaliyah - Try Again
Eminem - Stan
Radiohead - How To Disappear Completely
The Avalanches - Since I Left You
Missy Elliott - Get Ur Freak On
Alicia Keys - Fallin'
Blumfeld - Graue Wolken
The Moldy Peaches - Who's Got The Crack
The Strokes - Last Nite
Wilco - Ashes Of American Flags
Scissor Sisters - Comfortably Numb
The Libertines - What A Waster
LCD Soundsystem - Losing My Edge
Bruce Springsteen - My City Of Ruins
Herbert Gronemeyer - Mensch
Coldplay - In My Place
The Rapture - House of Jealous Lovers
The Roots And Cody Chesnutt - The Seed 2.0
The Mountain Goats - No Children
The Knife - Heartbeats
The White Stripes - Seven Nation Army
Beyonce Knowles And Jay-Z - Crazy In Love
OutKast - Hey Ya!
Franz Ferdinand - Darts of Pleasure
Kanye West - Through The Wire
Jay-Z - 99 Problems
TV On The Radio - Staring At The Sun
Joanna Newsom - The Book Of Right-On
Sido - Mein Block
Arcade Fire - Neighborhood #2 [Laika]
Snoop Dogg - Drop It Like It's Hot
Rufus Wainwright - The One You Love
Bright Eyes - First Day Of My Life
Antony And The Johnsons - Hope There's Someone
Seeed - Aufstehn!
Arctic Monkeys - I Bet You Look Good On The Dancefloor
The Gossip - Standing In The Way Of Control
Hot Chip - Over and Over
Neil Young (And Crazy Horse) - Living With War
Queens Of The Stone Age - Feel Good Hit Of The Summer
Lily Allen - Smile
Amy Winehouse - Rehab
Randy Newman - A Few Words In Defense Of Our Country
Rihanna - Umbrella
M.I.A. - Paper Planes
MGMT - Kids
Vampire Weekend - A-Punk
Fleet Foxes - White Winter Hymnal
Animal Collective - Summertime Clothes
Lady Gaga - Bad Romance
