@{"upper":"false","parenthese":"false","removeAfter":"false","type":"SONG","separator":"-","artistFirst":"true","auteur":"Rolling Stone","sorted":"false","size":"50","cat":"DECADE","rangeB":"1950","publish":"2010","name":"Rolling Stone - The Best Songs of the Decade - 50's - 2010","reverseArtist":"false","create":"07/09/2018 15:20:09","rangeE":"1959"}
Moondog - All Is Loneliness
Hank Williams - Cold, Cold Heart
Ruth Brown - Mama, He Treats Your Daughter Mean
Clyde McPhatter And Drifters - Money Honey
Marilyn Monroe - River Of No Return
Howlin' Wolf - Evil (Is Going On)
Muddy Waters - (I'm Your) Hoochie Coochie Man
Bill Haley And His Comets - (We're Gonna) Rock Around The Clock
Chordettes - Mr. Sandman
Crew-Cuts - Earth Angel
Bo Diddley - Bo Diddley
Fats Domino - Ain't That A Shame
Frankie Lymon And The Teenagers - Why Do Fools Fall In Love?
Richard Berry And The Pharaohs - Louie Louie
Guy Mitchell - Singing The Blues
Little Richard - Ready Teddy
Johnny Burnette Trio - Lonesome Train
Carl Perkins - Blue Suede Shoes
Johnny Cash - I Walk The Line
Roy Orbison - Ooby Dooby
Gene Vincent - Be-Bop-A-Lula
Elvis Presley - Hound Dog
Johnnie Ray - Just Walking In The Rain
Lavern Baker - Jim Dandy Got Married
Jimmy Reed - Honest I Do
Lloyd Price - Just Because
Patsy Cline - Walkin' After Midnight
The Everly Brothers - Bye Bye Love
Danny And The Juniors - At The Hop
Jerry Lee Lewis - Whole Lotta Shakin' Goin' On
Dale Hawkins - Susie Q
Sam Cooke - You Send Me
Buddy Holly - Not Fade Away
Don Gibson - Oh Lonesome Me
Link Wray - Rumble
The Johnny Otis Show - Willie And The Hand Jive
Duane Eddy - Cannonball
Ricky Nelson - Lonesome Town
Chuck Berry - Johnny B. Goode
Eddie Cochran - Summertime Blues
Cliff Richard - Move It
Frank Sinatra - One For My Baby (And One More For The Road)
Frankie Ford - Sea Cruise
Jackie Wilson - I'll Be Satisfied
Jacques Brel - Ne me quitte pas
Johnny Kidd And The Pirates - Please Don't Touch
Dion And The Belmonts - A Teenager In Love
Ray Charles - What'd I Say
Barrett Strong - Money (That's What I Want)
Ronnie Hawkins And Hawks - Mary Lou
