@{"upper":"false","parenthese":"false","removeAfter":"false","type":"ALBUM","separator":"-","artistFirst":"true","auteur":"The Guardian","sorted":"false","size":"40","cat":"YEAR","rangeB":"2015","publish":"2015","name":"The Guardian - Album - 2015","reverseArtist":"false","create":"25/08/2017 20:30:53","rangeE":"2015"}
Kendrick Lamar - To Pimp A Butterfly
Sufjan Stevens - Carrie And Lowell
Father John Misty - I Love You, Honeybear
Julia Holter - Have You In My Wilderness
Bjork - Vulnicura
Sleater-Kinney - No Cities To Love
Courtney Barnett - Sometimes I Sit and Think, and Sometimes I Just Sit
Kamasi Washington - The Epic
Young Fathers - White Men Are Black Men Too
Joanna Newsom - Divers
Miguel - Wildheart
Deerhunter - Fading Frontier
Wolf Alice - My Love Is Cool
Drake - If You're Reading This It's Too Late
Tame Impala - Currents
Floating Points - Elaenia
Jamie xx - In Colour
Unknown Mortal Orchestra - Multi-Love
Carly Rae Jepsen - EMOTION
Grimes - Art Angels
Susanne Sundfor - Ten Love Songs
New Order - Music Complete
Girl Band - Holding Hands with Jamie
Holly Herndon - Platform
Ezra Furman - Perpetual Motion People
Laura Marling - Short Movie
Mac Demarco - Another One
Natalie Prass - Natalie Prass
Sleaford Mods - Key Markets
Fantasma - Free Love
Chvrches - Every Open Eye
Jenny Hval - Apocalypse, Girl
Jessica Pratt - On Your Own Love Again
FFS - FFS
Dr. Dre - Compton
Vince Staples - Summertime '06
Janet Jackson - Unbreakable
John Grant - Grey Tickles, Black Pressure
Iron Maiden - The Book of Souls
Benjamin Clementine - At Least For Now
