Sean Rowe - Madman
JJ - V
Marissa Nadler - July
The Notwist - Close to the Glass
King Creosote - From Scotland with Love
The Roots - ...And Then You Shoot Your Cousin
Hollie Cook - Twice
Noura Mint Seymali - Tzenni
Ginger Baker - Why?
Cheveu - BUM
Scott Walker, Sunn O ))) - Soused
Aphex Twin - Syro
Brian Eno, Karl Hyde - Someday World
Childhood - Lacuna
Deerhoof - La Isla Bonita
Thurston Moore - The Best Day
Jessica93 - Rise
Fatima Al Qadiri - Asiatich
Dorian Pimpernel - Allombon
Bosco Delrey - The Green Tiger's Alibi
Cascadeur - Ghost Surfer
The Amazing Snakeheads - Amphetamine Ballads
Pharrell Williams - G I R L
Sohn - Tremors
BRNS - Patine
Chet Faker - Built On Glass
C.A.R - My Friend
Kate Tempest - Everybody Down
Camelia Jordana - Dans la peau
Mocke - L'Anguille
Ramona Lisa - Arcadia
Jeanne Cherhal - Histoire de J.
The Bug - Angels And Devils
Angel Olsen - Burn Your Fire for No Witness
Mina Tindle - Parades
Bror Gunnar Jansson - Moan Snake Moan
Mermonte - Audiorama
Beck - Morning Phase
The New Pornographers - Brill Bruisers
Depford Goth - Songs
Aquaserge - A l'amitie
Rodrigo Amarante - Cavalo
Swans - To Be Kind
Shabazz Palaces - Lese Majesty
Allah Las - Worship The Sun
Brigitte - A bouche que veux tu
The Acid - Liminal
Courtney Barnett - The Double EP
Fredo Viola - Revolutionary Son
Goat - Commune
Jean-Louis Murat - Babel
Nick Mulvey - First Mind
Temples - Sun Structures
Royal Blood - Royal Blood
Actress - Ghettoville
Asgeir - In The Silence
Miossec - Ici Bas, Ici Meme
Mogwai - Rave Tapes
Dick Annegarn - Velo va
St. Vincent - St. Vincent
The John Steel Singers - Everything's a Thread
Tahiti 80 - Ballroom
Real Estate - Atlas
Leonard Cohen - Popular Problems
Gruff Rhys - American Interior
Liars - Mess
Benjamin Booker - benjamin booker
The War on Drugs - Lost in the Dream
Moodoid - Le monde Moo
Joke - Ateyaba
How To Dress Well - What Is This Heart?
The Black Keys - Turn Blue
Yelle - Completement fou
Timber Timbre - Hot Dreams
Jack White - Lazaretto
Fauve - Vieux freres
The Do - Shake Shook Shaken
Julian Casablancas And The Voidz - Tyranny
Parquet Courts - Sunbathing Animal
AltJ - This Is All Yours
Sebastien Tellier - L'Aventura
Morrissey - World Peace Is None of Your Business
Lana Del Rey - Ultraviolence
SBTRKT - Wonder Where We Land
Todd Terje - It's Album Time
Perfume Genius - Too Bright
Baxter Dury - It's a Pleasure
Ariel Pink - pom pom
Flying Lotus - You're Dead!
Ty Segall - Manipulator
Avi Buffalo - At Best Cuckold
Jungle - Jungle
Caribou - Our Love
Metronomy - Love Letters
Florent Marchet - Bambi galaxy
Francois And The Atlas Mountains - Piano Ombre
FKA Twigs - LP1
Mac Demarco - Salad Days
Damon Albarn - Everyday Robots
christine and the queens - Chaleur humaine
