@{"upper":"false","parenthese":"false","removeAfter":"false","type":"ALBUM","separator":"-","artistFirst":"true","auteur":"Inrock","sorted":"false","size":"50","cat":"YEAR","rangeB":"1998","publish":"1998","name":"Inrock - Album - 1998","reverseArtist":"false","create":"10/09/2018 13:31:05","rangeE":"1998"}
Mercury Rev - Deserter's Song
Rufus Wainwright - Rufus Wainwright
Beck - Mutations
Massive Attack - Mezzanine
The Jon Spencer Blues Explosion - Acme
Leila - Like Weather
R.E.M. - Up
Manu Chao - Clandestino
Elliot Smith - XO
Placebo - Without You I'm Nothing
Mark Hollis - Mark Hollis
The Third Eye Foundation - You Guys Kill Me
Portishead - Live Roseland NYC
Black Box Recorder - England Made Me
Jurassic 5 - J5
Tue-Loup - La Bancale
Roudoudou - Tout L'univers ( Listerner's Digest )
Cornelius - Fantasma
Alain Bashung - Fantaisie Militaire
P.J. Harvey - Is This Desire ?
Stephen Duffy - I Love My Friends
Morcheeba - Big Calm
Sparklehorse - Good Morning Spider
Sunhouse - Crazy On The Week End
Kruder And Dorfmeister - The K And D Sessions
Garbage - Version 2.0
Bran Van 3000 - Glee
The Smashing Pumpkins - Adore
Air - Moon Safari
Boo Radleys - Kingsize
Cat Power - Moon Pix
Perry Blake - Perry Blake
Tarwater - Silur
Freestylers - We Rock Hard
Lo-Fidelity Allstars - How To Operate With A Blown Mind
Pulp - This Is Hardcore
Tortoise - TNT
Calexico - The Black Light
Jeff Buckley - Sketches For My Sweetheart The Drunk
The Beta Band - 3 Ep's
The Dandy Wharhols - Come Down
Drugstore - White Magic For Lovers
Miossec - A Prendre
Beastie Boys - Hello Nasty
Johnny Dowd - West Of Memphis
U.N.K.L.E - Psyence Fiction
Talvin Singh - OK
Rae And Christian - Northers Sulphuric Soul
The Little Rabbits - Yeah !
Cosmo Vitelli - Video
