Drake - Hotline Bling
Tame Impala - Let It Happen
David Bowie - Blackstar
Tobias Jesso Jr. - How Could You Babe
Girl Band - Why They Hide Their Bodies Under My Garage
Kurt Vile - Pretty Pimpin
Monika - Secret in the Dark
Flavien Berger - La fete noire
Shamir - On The Regular
PNL - Le monde ou rien
ALA.NI - Darkness at Noon
Alessia Cara - Here
Alex G - Harvey
Algiers - Blood
Baio - Endless Rhythm
Beach House - Space Song
Benjamin Clementine - Adios
Bjork - Lionsong
Blur - Go Out
Bonnie Banane - Leonardo
Bully - Trying
C Duncan - Say
Charlie Cunningham - Own Speed
Chastity Belt - Joke
Chromatics - Shadow (Radio Edit)
Courtney Barnett - Pedestrian at Best
Declan McKenna - Brazil
DIIV - Dopamine
Django Django - First Light
Elliot Moss - Slip
Feu! Chatterton - Boeing
Flo Morrissey - Pages of Gold
Formation - Hangin
Gengahr - She's a Witch
Grimes - Venus Fly (And Janelle Monae)
Gwilym Gold - Triumph
Ibeyi - Oya
J.C. Satan - Satan II
Jacques - Faites quelque chose
Jamie xx - I Know There's Gonna Be (Good Times) [And Young Thug And...
Kendrick Lamar - King Kunta
LA Priest - Party Zute / Learning to Love
Lana Del Rey - Honeymoon
Motorama - Red Drop
Natalie Prass - Bird of Prey
Nekfeu - Le horla
Odezenne - Bouche a levres
Oscar - Breaking My Phone
Pixx - Fall In
Sufjan Stevens - Carrie And Lowell
The Internet - Girl (And KAYTRANADA)
The Shoes - Give It Away (And Postaal)
WE ARE MATCH - Radical
Young Thug - Check
Layla - Bachar Mar-Khalife
Satellites - Bill Ryder-Jones
