Vampire Weekend - Modern Vampires of the City
Kanye West - Yeezus
Disclosure - Settle
My Bloody Valentine - mbv
Danny Brown - Old
Deafheaven - Sunbather
Daft Punk - Random Access Memories
Majical Cloudz - Impersonator
Savages - Silence Yourself
Arcade Fire - Reflektor
Darkside - Psychic
Chance The Rapper - Acid Rap
Kurt Vile - Wakin on a Pretty Daze
The Knife - Shaking the Habitual
Sky Ferreira - Night Time, My Time
Bill Callahan - Dream River
Haim - Days Are Gone
Janelle Monae - The Electric Lady
Earl Sweatshirt - Doris
Jai Paul - demos
Blood Orange - Cupid Deluxe
Waxahatchee - Cerulean Salt
DJ Rashad - Double Cup
Oneohtrix Point Never - R Plus Seven
Drake - Nothing Was the Same
James Blake - Overgrown
Neko Case - The Worse Things Get, The Harder I Fight, The Harder I Fight, The More I Love You
Run the Jewels - Run the Jewels
The Haxan Cloak - Excavation
Deerhunter - Monomania
Autre Ne Veut - Anxiety
DJ Koze - Amygdala
Burial - Truant / Rough Sleeper
Forest Swords - Engravings
Phosphorescent - Muchacho
Chvrches - The Bones Of What You Believe
Jon Hopkins - Immunity
Boards of Canada - Tomorrow's Harvest
AsAP Rocky - Long.Live.AsAP
Parquet Courts - Light Up Gold
Mutual Benefit - Love's Crushing Diamond
Rhye - Woman
The National - Trouble Will Find Me
Justin Timberlake - The 20/20 Experience
Fuck Buttons - Slow Focus
M.I.A. - Matangi
The Range - Nonfiction
Speedy Ortiz - Major Arcana
Julia Holter - Loud City Song
Pusha T - My Name Is My Name
