Black Mountain - In The Future
TV On The Radio - Dear Science
The Roots - Rising Down
The Black Keys - Attack And Release
The Kills - Midnight Boom
Cut Copy - In Ghost Colours
The Killers - Day And Age
Shearwater - Rook
Man Man - Rabbit Habits
Get Well Soon - Rest Now, Weary Head! You Will Get Well Soon
Caravan Palace - Caravan Palace
Beck - Modern Guilt
The Verve - Forth
The Mars Volta - The Bedlam in Goliath
Fleet Foxes - Fleet Foxes
No Age - Nouns
M83 - Saturdays = Youth
Bloc Party - Intimacy
Bon Iver - For Emma, Forever Ago
These New Puritans - Beat Pyramid
Cold War Kids - Loyalty To Loyalty
Beach House - Devotion
Ra Ra Riot - The Rhumb Line
Melissa Laveaux - Camphor And Copper
Stereolab - Chemical Chords
The Notwist - The Devil, You And Me
Marie Modiano - Outland
Neimo - Moderne Incidental
Jakob Dylan - Seeing Things
MGMT - Oracular Spectacular
Tricky - Knowle West Boy
Hercules And Love Affair - Hercules And Love Affair
Flight of the Conchords - Flight of the Conchords
She And Him - Volume One
Rascals - Rascalize
Hot Chip - Made In The Dark
Death Cab for Cutie - Narrow Stairs
Julien Dore - Ersatz
Motorhead - Motorizer
The Hold Steady - Stay Positive
The Black and White Years - The Black and White Years
