@{"upper":"false","parenthese":"false","removeAfter":"false","type":"SONG","separator":"-","artistFirst":"false","auteur":"Le Choix","sorted":"false","size":"30","cat":"GENRE","rangeB":"0","publish":"2009","name":"Le Choix - Rap - 2009","reverseArtist":"false","create":"30/07/2018 18:33:46","rangeE":"2009"}
Rapper's Delight - The Sugarhill Gang	
Unity - Afrika Bambaataa	
I Ain't No Joke - Eric B. And Rakim	
Juicy - The Notorious B.I.G.	
Nuthin' But a 'G' Thang - Snoop Dogg	
The Message (And Melle Mel And Duke Bootee) - Grandmaster Flash And The Furious Five	
Bring The Noise - Public Enemy	
No Sleep Till Brooklyn - Beastie Boys	
Walk This Way - Run–D.M.C.	
C.R.E.A.M. - Wu-Tang Clan	
Express Yourself - N.W.A.	
Dear Mama - 2Pac	
The World Is Yours - Nas	
Gangsta's Paradise And L.V. - Coolio	
Pose ton Gun - Supreme NTM	
Nes sous la meme etoile - Iam	
Ready or Not - Fugees	
Lose Yourself - Eminem	
Hits from the Bong - Cypress Hill	
Mr. Carter - Lil Wayne	
Jesus Walks - Kanye West	
99 Problems - JAY Z	
Get By - Talib Kweli	
Get Ur Freak On - Missy Elliott	
The Seed (2.0) - The Roots	
Reunion - Slum Village	
Can I Kick It? - A Tribe Called Quest	
Shook Ones, Pt. II - Mobb Deep	
Oh No - Mos Def	
Full Clip - Gang Starr
