@{"upper":"false","parenthese":"false","removeAfter":"false","type":"ALBUM","separator":"-","artistFirst":"true","auteur":"Uncut","sorted":"false","size":"70","cat":"YEAR","rangeB":"2000","publish":"2000","name":"Uncut - Album - 2000","reverseArtist":"false","create":"03/09/2018 10:35:17","rangeE":"2000"}
Lambchop - Nixon
Primal Scream - Xtrmntr
Radiohead - Kid A
Badly Drawn Boy - The Hour Of Bewilderbeast
Eminem - The Marshall Mathers LP
Emmylou Harris - Red Dirt Girl
Outkast - Stankonia
Ryan Adams - Heartbreaker
Kid 606 - Down With The Scene
Birth - Gotton Bold
Steely Dan - Two Against Nature
The Magnetic Fields - 69 Love Songs
The Kingsbury Manx - The Kingsbury Manx
Leila - Courtesy Of Choice
Godspeed You Black Emperor! - Lift Yr Skinny Fists Like Antennas To The Sky
Warren Zevon - Life'll Kill Ya
Phoenix - United
Calexico - Hot Rail
The Web Brothers - Maroon
Lewis Taylor - Lewis II
Lou Reed - Ecstacy
Amon Tobin - Supermodified
Smog - Dongs Of Sevotion
Doves - Lost Souls
The Go-Betweens - The Friends Of Rachel Worth
Gonzales - The Entertainist
Willard Grant Conspiracy - Everything's Fine
Kellies - Kaleiderscope
Deltron 3030 - Deltron 3030
The For Carnation - The For Carnation
Broadcast - The Noise Made By People
Knife In The Water - Plays One Around The Other
Goldfrapp - Felt Mountain
The Handsome Family - In The Air
Eels - Daisies Of The Galaxy
Elliott Smith - Figure 8
Marah - Kids In Philly
Patti Smith - Gung Ho
Yo La Tengo - And Then Nothing Turned Itself Inside Out
Jeff Buckley - Mystery White Boy
Sonic Youth - Nyc Ghosts And Flowers
Dr Dre - 2001
Joe Pernice - Big Tobacco
Add N To X - Add Insult To Injury
The Mighty Wah! - Songs Of Strength And Heartache
Chris Morris - Blue Jam
The Twilight Singers - Twilight As Played By The Twilight Singers
St Ettienne - Sound Of Water
Black Box Recorder - The Facts Of Life
XTC - Wasp Star: Apple Venus Vol. 2
Apples In Stereo - The Discovery Of The World Inside The Moone
Clinic - Internal Wrangler
The Shazam - Goodspeed The Shazam
...And You Will Know Us By The Trail Of Dead - Madonna
Go-Kart Mozart - Instant Wigwam And Igloo Mixture
Asian Dub Foundation - Community Music
Elastica - The Menace
Romanthony - R Hide In Plain Site
June And The Exit Wounds - A Little More Heaven Hamilton, Please
Max Tundra - Some Best Friend You Turned Out To Be
Brave Captain - Go With Yourself
Mandalay - Instinct
Fatboy Slim - Halfway Between The Gutter And The Stars
The Russian Futurists - The Method Of Modern Love
The Wu-Tang Clan - The W
Giant Sand - Chore Of Enchantment
David Holms - Bow Down At The Exit Sign
The Hight Llamas - Buzzle Bee
Bent - Programmed To Love
PJ Harvey - Stories From The City, Stories From The Sea
