@{"upper":"false","parenthese":"false","removeAfter":"false","type":"SONG","separator":"-","artistFirst":"true","auteur":"NME","sorted":"false","size":"75","cat":"GENRE","rangeB":"0","publish":"2005","name":"NME - 75 Tunes That Defined Rock Roll - 2005","reverseArtist":"false","create":"04/09/2018 15:48:04","rangeE":"2005"}
#This List Was Presented In A Supplement To Mark The 3000th Edition Of NME

#The Basics…

Artic Monkeys - Fake Tales Of San Francisco
Blue - Girls And Boys
Bob Dylan - Like A Rolling Stone
Elvis Presley - Heartbreak Hotel
Franz Ferdinand - Take Me Out
Joy Division - Love Will Tear Us Apart
Manic Street Preachers - You Love Us
Nirvana - Smells Like Teen Sprit
Oasis - Live Forever
Pixies - Debaser
Radiohead - I Want None Of It
Razorlight - Golden Touch
Sex Pistols - Anarchy In The UK
The Clash - London Calling
The Killers - Somebody Told Me
The Libertines - Can't Stand Me Now
The Rolling Stones - (I Can't Get No) Satisfaction
The Smiths - How Soon Is Now
The Stone Roses - Love Spreads
The Streets - Dry Your Eyes
The Strokes - Last Night
The Velvet Underground - I'm Waiting For The Man
The White Stripes - Seven Nation Army
The Who - My Generation
U2 - New Years Day

#Next Steps…

Blondie - One Way Or Another
Bob Marley - No Woman No Cry
Coldplay - Yellow
Cornershop - Brimful Of Asha
David Bowie - Changes
Eminem - My Name Is
Happy Mondays - Step On
Jimi Hendrix - Hey Joe
Kaiser Chiefs - I Predict A Riot
Kraftwerk - Autobahn
Marvin Gaye - I Herd It Through The Grapevine
Primal Scream - Loaded
Public Enemy - Fight The Power
Pulp - Common People
Ramones - Sheena Is A Punk Rocker
Roxy Music - Street Life
T.Rex - Jeepster
The Beach Boys - Good Vibrations
The Birds - Turn Turn Turn
The Cure - In Between Days
The Jesus And Mary Chain - Just Like Honey
The Kinks - Waterloo Sunset
The La's - There She Goes
The Prodigy - Firestarter
The Verve - Bitter Sweet Symphony
Yeah Yeah Yeahs - Maps


#Deep Cuts…

ABC - The Look Of Love
Aphex Twin - Come To Daddy
Arcade Fire - Power Out
Buzzcocks - Ever Fallen In Love...
Chuck Berry - Johnny B Goode
Dexy's Midnight Runners - Geno
Grandmaster Flash - White Lines (Don't Do It)
Lcd Soundsystem - Losing My Edge
Madonna - Into The Groove
Michael Jackson - Don't Stop 'Till You Get Enough
Missy Elliott - Get Ur Freak On
Morrissey - Suedehead
Prince - When Doves Cry
Queens Of The Stoneage - The Lost Art Of Keeping A Secret
Talking Heads - Once In A Lifetime
The Beat - Mirror In The Bathroom
The Breeders - Cannonball
The Doors - People Are Strange
The Flaming Lips - Race For The Prize
The Human League - Love Action
The Jam - Going Underground
The Rapture - House Of Jealous Lovers
Thin Lizzy - The Boys Are Back In Town
Underworld - Born Slippy
