@{"upper":"false","parenthese":"false","removeAfter":"false","type":"ALBUM","separator":"-","artistFirst":"true","auteur":"NME","sorted":"false","size":"50","cat":"THEME","rangeB":"0","publish":"2010","name":"NME - The 50 Greatest Debut Albums Ever - 2010","reverseArtist":"false","create":"04/09/2018 15:50:40","rangeE":"2010"}
Joan Baez - Joan Baez
The Shadows - The Shadows
Bob Dylan - Bob Dylan
The Beatles - Please Please Me
Dusty Springfield - A Girl Called Dusty
The Who - My Generation
The Mothers Of Invention - Freak Out
The Velvet Underground - The Velvet Underground
The Band - Music From Big Pink
The Stooges - The Stooges
Black Sabbath - Black Sabbath
Thin Lizzy - Thin Lizzy
Neu! - Neu!
New York Dolls - New York Dolls
Brian Eno - Here Come The Warm Jets
Patti Smith - Horses
Ramones - Ramones
Sex Pistols - Never Mind The Bollocks...
Devo - Q: Are We No Men? A: We Are Devo!
Joy Division - Unknown Pleasures
Killing Joke - Killing Joke
Depeche Mode - Speak And Spell
ABC - The Lexicon Of Love
R.E.M. - Murmur
The Smiths - The Smiths
The Jesus And Mary Chain - Psychocandy
Beastie Boys - Licensed To Ill
Guns N' Roses - Appetite For Destruction
My Bloody Valentine - Isn't Anything
The Stone Roses - The Stone Roses
The La's - The La's
Massive Attack - Blue Lines
Manic Street Preachers - Generation Terrorists
Suede - Suede
Oasis - Definite Maybe
Elastica - Elastica
Super Furry Animals - Fuzzy Logic
Roni Size - New Forms
Lauryn Hill - The Miseducation Of Lauryn Hill
Eminem - The Slim Shady LP
Coldplay - Parachutes
The Strokes - Is This It
The Libertines - Up The Bracket
Dizzee Rascal - Boy In Da Corner
Kanye West - The College Dropout
Arcade Fire - Funeral
Arctic Monkeys - Whatever People Say I Am, That's What I'm Not
Klaxons - Myths Of The Near Future
Crystal Castles - Crystal Castles
The XX - The XX
