@{"upper":"false","parenthese":"false","removeAfter":"false","type":"SONG","separator":"-","artistFirst":"true","auteur":"NME","sorted":"false","size":"50","cat":"DECADE","rangeB":"2010","publish":"2015","name":"NME - Tracks Of The Decade (2010's)...So Far - 2015","reverseArtist":"false","create":"02/07/2017 07:08:56","rangeE":"2015"}
Frank Ocean - Pyramids
Royal Blood - Little Monster
Arctic Monkeys - I Wanna Be Yours
St Vincent - Digital Witness
M83 - Midnight City
The Horrors - I Can See Through You
Foster The People - Pumped Up Kids
The Vaccines - Post Break Up Sex
Janelle Monae - Tightrope
Drenge - Bloodsports
Iceage - Iceage (Broken Bone)
Fat White Family - Touch The Leather
Jake Bugg - Lightening Bolt
Cold Cave - The Great Pan Is Dead
The National - Bloodbuzz Ohio
Warpaint - Undertow
These New Puritans - We Want War
Best Coast - Boyfriend
Jungle - Busy Earnin'
Arcade Fire - Ready To Start
Lord - Royals
Blur - Under The Westway
David Bowie - Where Are We Now
Pulp Vs Soulwax - After You
Metronomy - The Bay
Crystal Castles - Plague
Lcd Soundsystem - Drunk Girls
Grinderman - Heathen Child
Noel Galagher's High Flying Birds - Aka What A Life
Jack White - Sixteen Saltanes
Arcade Fire - We Used To Wait
Kanye West - Power
MIA - Born Free
Gorillaz - Stylo
Tyler The Creator - Yonkers
Arctic Monkeys - R U Mine
Jamie T - Zombie
Pond - Xanman
Grimes - Oblivion
Future Islands - Seasons (Waiting On You)
Disclosure - White Noise
Palma Violets - Best Of Friends
Alt-J - Breezeblocks
Tame Impala - Elephant
Lana Del Rey - Video Games
Azealla Banks - 212
Foals - Spanish Sahara
Arctic Monkeys - Do I Wanna Know?
Daft Punk - Get Lucky
Watch The Throne - Niggas In Paris
