@{"upper":"false","parenthese":"false","removeAfter":"false","type":"ALBUM","separator":"-","artistFirst":"false","auteur":"NME","sorted":"false","size":"50","cat":"ALL_TIME","rangeB":"0","publish":"2016","name":"NME - 50 Albums To Hear Before You Die - 2016","reverseArtist":"false","create":"25/08/2017 20:30:52","rangeE":"2016"}
#Format - Album Title - Artist 
The B 52'S - The B 52's 
The Beatles - The Beatles
Live At Carnegie Hall - Bill Withers 
Raw Power - The Stooges 
Joe's Garage, Acts I, Ii And Iii - Frank Zappa
Nia - Blackalicious 
Thriller - Michael Jackson 
Buzz Or Howl Under The Influence Of Heat - Minutemen 
White Light/White Heat - The Velvet Underground
Blond On Blond - Bob Dylan
Forty Licks - The Rolling Stones 
The Stone Roses - The Stone Roses
Louder Than Bombs - The Smiths 
Run-DMC - Run-DMC 
Broke With Expensive Taste - Azealia Banks 
Transformer - Lou Reed 
Abraxas - Santana 
2001 - Dr Dre 
Rainmaker - Michael Chapman 
Captain Beyond - Captain Beyond 
Fifth Dimension - The Byrds 
Reconstruction Site - The Weakerthans 
Trans-Europe Express - Kraftwerk 
New Skin For Old Ceremony - Leonard Cohen 
Scream! - Scream 
Music From The Good The Bad And The Ugly - Hugo Montenegro 
Rollercoaster - Red House Painters 
I Want You - Marvin Gaye 
Fantastic Planet - Failure 
Master Of Reality - Black Sabbath 
Diamond Dogs - David Bowie 
Travelin' At The Speed Of Thought - The O'jays 
Tres Hombres - Zz Top 
The Soft Bulletin - The Flaming Lips
Boxer - The National 
A Love Supreme - John Coltrane 
Chrome - Catherine Wheel 
Ghost Of A Chance - Turboweekend 
Teaser And The Firecat - Cat Stevens 
Blood On The Tracks - Bob Dylan
Jacques Dutronc - Jacques Dutronic 
Night Drive - Chromatics 
Weld - Neil Young And Crazy Horse 
21 Singles - The Jesus And Mary Chain 
Stephen Malkmus - Stephen Malkmus 
Sand In Vaseline: Popular Favourites - Talking Heads 
Abby Road - The Beatles
Forever Changes - Love 
Four Sail - Love
