@{"upper":"false","parenthese":"false","removeAfter":"false","type":"ALBUM","separator":"-","artistFirst":"true","auteur":"NME","sorted":"false","size":"101","cat":"ALL_TIME","rangeB":"0","publish":"2014","name":"NME - 101 Albums To Hear Before You Die - 2014","reverseArtist":"false","create":"04/09/2018 15:19:17","rangeE":"2014"}
#Selected By A Host Of Music Industry Personnel.
Love - Four Sail
Jacques Dutronc - Jacques Dutronic
Kendrick Lamar - Section.80
John Coltrane - A Love Supreme
Love - Forever Changes
Lou Reed - Transformer
Don Cherry And Ed Blackwell - El Corazon
Nirvana - In Utero
Outkast - Stankonia
Pink Floyd - A Saucerful Of Secrets
The Space Lady - The Space Lady's Greatest Hits
Led Zeppelin - Led Zeppelin IV
The Beatles - Revolver
The Shags - Philosophy Of The World
Blask Sabbath - Master Of Reality
Roland S Howard - Teenage Snuff Film
Huggy Bear - Taking The Rough With The Smooch
Brian Eno - Here Come The Warm Jets
Minutemen - Buzz Or Howl Under The Influence Of Heat
Led Zeppelin - Houses Of The Holy
Red House Painters - Rollercoaster
The B-52's - The B-52's
The O'Jays - Travelin' At The Speed Of Thought
Van Morrison - Astral Weeks
Run-DMC - Run-DMC
Chromatics - Night Drive
Yellow Magic Orchestra - Bgm
Kong - Snake Magnet
Cro-Mags - The Age Of Quarrel
The Velvet Underground - White Light/White Heat
Bob Dylan - Blond On Blond
Santana - Abraxas
Dr Dre - 2001
Michael Chapman - Rainmaker
Captain Beyond - Captain Beyond
J Dilla - Donuts
Fela Kuti - Shuffering And Shimiling
The National - Boxer
T2 - It Will All Work Out In Boomland
The Byrds - Fifth Dimension
Lauryn Hill - The Miseducation Of... 
The Holy Modal Rounders - The Holy Model Rounders
Public Enemy - Fear Of A Black Planet
Buffy Sainte-Marie - Illuminations
Blackalicious - NIA
Michael Jackson - Thriller
MIA - Matangi
Bernard Herrmann - Psycho OST
The Clash - The Clash
Casino Verses Japan - Whole Numbers Play The Basics
Bob Dylan - Blood On The Tracks
The Smiths - Louder Than Bombs
Dead Kennedys - Plastic Surgery Disasters
Kraftwerk - Trans-Europe Express
Super Furry Animals - Fuzzy Logic
Elliott Smith - From A Basement On The Hill
The Weakerthans - Reconstruction Site
Scream - Scream!
The Jesus And Mary Chain - Psychocandy
The Last Poets - The Last Poets
Scritti Politti - Cupid And Psyche 85
Radiohead - In Rainbows
Bjork - Homogenic
Two Lone Swordsman - From The Double Gone Chapel
The Vines - Highly Evolved
PJ Harvey - Is This Desire?
Spaceman 3 - Performance
Health - Health
Failure - Fantastic Planet
Paul McCartney - McCartney II
Suicide - Suicide
Hugo Montenegro - Music From The Good, The Bad And The Ugly
Snoop Doggy Dogg - Doggystyle
Neil Young And Crazy Horse - Weld
Girls - Album
Neil Young - On The Beach
Durutti Column - LC
Guns N' Roses - Appetite For Destruction
X - X-Aspirations
Cat Stevens - Teaser And The Firecat
XTC - Skylarking
Steely Dan - Katy Lied
Bill Withers - Live At Carnegie Hall
Jimi Hendrix - Electric Ladyland
Simon Joyner - Songs For The New Year
The European - In A Very Real Sense Now
Lana Del Rey - Born To Die
Jamie T - Panic Prevention
Charlotte Gainsbourg - Charlotte For Ever
Germs - (GI)
Talk Talk - Sprit Of Eden
Lou Reed - Berlin
Oasis - Definitely Maybe
Smashing Pumpkins - Siamese Dream
ESG - Come Away With ESG
Life Without Buildings - Any Other City
Iggy And The Stooges - Raw Power
Queens Of The Stoneage - Songs For The Deaf
Dandelion Gum - Black Moth Super Rainbow
Joni Mitchell - Blue
Clara Rockmore - The Art Of The Therenin
