Cry - Johnnie Ray
Crying In The Chapel - The Orioles
Shake, Rattle And Roll - Big Joe Turner
Tutti Frutti - Little Richard
Heartbreak Hotel - Elvis Presley
Whole Lotta Shakin - Goin - On - Jerry Lee Lewis
Johnny B Goode - Chuck Berry
What'd I Say - Ray Charles
Will You Still Love Me Tomorrow - The Shirelles
Running Scared - Roy Orbison
You Really Got A Hold On Me - Smokey Robinson And The Miracles
She Loves You - The Beatles
You Really Got Me - The Kinks
Like A Rolling Stone - Bob Dylan
Pet Sounds - The Beach Boys
The Velvet Underground And Nico - The Velvet Underground And Nico
Jumping Jack Flash - The Rolling Stones
Astral Weeks - Van Morrison
Live At Leeds - The Who
What's Going On - Marvin Gaye
The Harder They Come - Various Artists
20th Century Boy - T-Rex
Tales From Topographic Oceans - Yes
Autobahn - Kraftwerk
Anarchy In The Uk - The Sex Pistols
Low - David Bowie
Public Image - Public Image Ltd
Good Times - Chic
Closer - Joy Division
Adventures On The Wheels Of Steel - Grandmaster Flash
Do You Really Want To Hurt Me? - Culture Club
Blue Monday - New Order
The Smiths - The Smiths
Psychocandy - The Jesus And Mary Chain
Kiss - Prince
Pump Up The Volume - M/A/R/R/S
It Takes A Nation Of Millions To Hold Us Back - Public Enemy
Fools Gold - The Stone Roses
Loaded - Primal Scream
Nevermind - Nirvana
