Future And Pharrell, Pusha T, And Casino - Move That Dope
Warpaint - Disco/very
Meghan Trainor - All About That Bass
The War on Drugs - Red Eyes
Timber Timbre - Hot Dreams
Swans - She Loves Us!
Sharon Van Etten - Every time the Sun Comes Up
Shabazz Palaces - Forerunner Foray
Lykke Li - No Rest for the Wicked
Leonard Cohen - Did I Ever Love You
Broncho - Class Historian
Iamamiwhoami - Chasing Kites
Common feat Big Sean - Diamonds
SOHN - Artifice
Ariel Pink - Put Your Number in My Phone
Wussy - Teenage Wasteland
Brantley Gilbert - Bottoms Up
We Are Scientists - Make It Easy
Melanie de Biasio - Sweet Darling Pain
Twin Peaks - Making Breakfast
tUnE-yArDs - Water Fountain
The Twilight Sad - There's a Girl in the Corner
The New Pornographers - Backstairs
Sondre Lerche - Bad Law
Nicki Minaj - Anaconda
Lydia Loveless - Wine Lips
Katy B - Crying for No Reason
Julion Alvarez y Su Norteno Banda - Y Asi Fue
Jessie Ware - Say You Love Me
Little Dragon - Klapp Klapp
Run the Jewels - Early
Vince Staples - Blue Suede
Hallelujah the Hills - I Stand Corrected
Sun Kil Moon - Richard Ramirez Died Today of Natural Causes
Elephant - Shapeshifter
Sturgill Simpson - Turtles All the Way Down
Dum Dum Girls - Are You Okay?
Cloud Nothings - I'm Not Part of Me
Ariana Grande - Problem
Saint Savior - Nobody Died
Angel Olsen - Forgiven/Forgotten
Ambrose Akinmusire - Our Basement (Ed)
Alvvays - Archie, Marry Me
Kira Isabella - Quarterback
Ryan Adams - Gimme Something Good
Sylvan Esso - Coffee
Perfume Genius - Queen
Sleater Kinney - Bury Our Friends
Jamestown Revival - California (Cast Iron Soul)
Kendrick Lamar - I
Jenny Lewis - She's Not Me
Nickel Creek - Destination
Charli XCX - Boom Clap
Schoolboy Q - Collard Greens
Grouper - Holding
Royksopp And Robyn - Do It Again
Old Crow Medicine Show - Sweet Amarillo
Big K.R.I.T. - Cadillactica
Caribou - Can't Do Without You
St. Vincent - Digital Witness
Owen Pallett - The Riverbed
First Aid Kit - Stay Gold
Todd Terje And Bryan Ferry - Johnny And Mary
Spoon - Do You
Sia - Chandelier
Azealia Banks - Chasing Time
Against Me! - Transgender Dysphoria Blues
Wild Beasts - Wanderlust
Parker Millsap - Truckstop Gospel
Clean Bandit - Rather Be
Mike Farris - Mercy Now
Taylor Swift - Shake It Off
FKA Twigs - Two Weeks
Future Islands - Seasons (Waiting on You)
Flying Lotus - Never Catch Me
