@{"upper":"false","parenthese":"false","removeAfter":"false","type":"ALBUM","separator":"-","artistFirst":"true","auteur":"Q","sorted":"false","size":"50","cat":"YEAR","rangeB":"1989","publish":"1989","name":"Q - Album - 1989","reverseArtist":"false","create":"28/08/2018 11:34:10","rangeE":"1989"}
Adeva - Adeva!
Aerosmith - Pump
The Beautiful South - Welcome to ...
The Blue Nile - Hats
David Byrne - Rei Momo
Tracy Chapman - Crossroads
Neneh Cherry - Raw like sushi
Eric Clapton - Journeyman
Elvis Costello - Spike
Deacon Blue - When the world knows your name
De La Soul - 3 Feet high and rising
Bob Dylan - Oh mercy
Erasure - Wild!
Eurythmics - We too are one
Fine young cannibals - The raw and the cooked
Peter Gabriel - Passion
The gipsy kings - Mosaique
John Lee Hooker - The healer
Lenny Kravitz - Let love rule
Daniel Lanois - Acadie
Paul McCartney - Flowers in the dirt
Kirsty Maccoll - Kite
Madonna - Like a prayer
Van Morrison - Avalon Sunset
Les Negresses - Mlah
Neville Brothers - Yellow moon
Roy Orbison - Mystery Girl
Tom Petty - Full moon fever
Pixies - Doolittle
The Pogues - Peace and Love
Prefab Sprout - Protest songs
Prince - Batman
Chris Rea - The road to hell
Dan Reed Network - Slam
Lou Reed - New York
Rolling Stones - Steel Wheels
S'Express - Original soundtrack
Simple minds - Street fighting years
Simply red - A new flame
Soul II Soul - Club classics Vol I
The stone roses - same
Tears for fears - The seeds of love
Tin Machine - same
Tone loc - Loc'ed after dark
The triffids - The black swan
Various artists - Italia: Dance music from Italy
Wet wet wet - Holding back the river
Loudon Wainwright III - Therapy
The wonder stuff - Hup
Neil Young - Freedom 
