@{"upper":"false","parenthese":"false","removeAfter":"false","type":"ALBUM","separator":"-","artistFirst":"true","auteur":"Q","sorted":"false","size":"46","cat":"YEAR","rangeB":"2001","publish":"2001","name":"Q - Album - 2001","reverseArtist":"false","create":"28/08/2018 11:39:39","rangeE":"2001"}
Travis - The invisible band
Ryan Adams - Gold
Air - 100000 Hz Legend
Andrew W.K. - I Get Wet
Ash - Free All Angels
The Avalanches - Since I Left You
Basement Jaxx - Rooty
The Charlatans - Wonderland
Cosmic Rough Riders - Enjoy The Melodic Sunshine
Daft Punk - Discovery
Dido - No Angel
Bob Dylan - Love And Theft
Elbow - Asleep At The Back
Missy Elliott - Miss E.... So Addictive
Nelly Furtado - Whoa, Nelly
Gorillaz - Gorillaz
John Hammond - Wicked Grin
Ed Hardcourt - Here Be Monsters
Jamiroquai - A Funk Odyssey
Jimmy Eat World - Bleed American
Alicia Keys - Songs In A Minor
Baaba Maal - Missing You (Mi Yeewnii)
Mercury Rev - All Is Dream
Mull Historical Society - Loss
Muse - Origin Of Symmetry
N*E*R*D - In Search Of
New Order - Get Ready
Outkast - Stankonia
Oxide And Neutrino - Execute
Playgroup - Playgroup
Radiohead - Amnesiac
R.E.M. - Reveal
Roots Manuva - Run Come Save Me
Semisonic - All About Chemistry
Spritualized - Let It Come Down
Starsailor - Love Is Here
Stereophonics - Just Enough Education To Perform
The Stroks - Is This It
Super Furry Animals - Rings Around The World
Tool - Lateralus
Travis - The Invisible Band
Turin Breaks - The Optimist LP
Rufus Wainwright - Poses
Weezer - The Green Album
The White Stripes - White Blood Cells
Lucinda Williams - Essence 
