@{"upper":"false","parenthese":"false","removeAfter":"false","type":"ALBUM","separator":"-","artistFirst":"true","auteur":"Q","sorted":"false","size":"50","cat":"YEAR","rangeB":"1987","publish":"1987","name":"Q - Album - 1987","reverseArtist":"false","create":"28/08/2018 11:33:49","rangeE":"1987"}
Anthrax - Among the living
The Beatles - Revolver
Regina Belle - All by myself
The Christians - same
Creedence Clearwater Revival - Chronicle
The Cure - Kiss me, Kiss me, Kiss me
Def Leppard - Hysteria
Joe Ely - Lord of the Highway
Eurythmics - Savage
The Fabulous Thunderbirds - Portfolio
Fleetwood Mac - Tango in the night
John Hiatt - Bring the family
Husker Du - Warehouse (songs and stories)
Chris Isaak - Same
Joe Jackson - Will power
Michael Jackson - Bad
Jesus and Mary chain - Darklands
New Order - Substance
Randy Newman - Lonely at the top
Alexander O'Neal - Hearsay
Dolly Parton, Linda Ronstadt, Emmylou Harris - Trio
Penguin Cafe Orchestra - Signs of life
Lee 'Scratch' Perry - Time boom X de devil dead
Salif Keita - Soro
LL Cool J - Bigger and Deffer
Marillion - Clutching at straws
Mel And Kim - F.L.M.
Van Morrison - Poetic champions compose
Najma - Qareeb
Pet shop boys - Actually
Pop will eat itself - Box frenzy
Elvis Presley - The all time greatest hits
Maxi Priest - Maxi
Prince - Sign 'o' the times
Chris Rea - Dancing with strangers
REM - Document
The Replacements - Pleased to meet me
Robbie Robertson - Same
Marta Sebestyen - Same
Shirati jazz - Benga beat
Simply red - Men and woman
The Smiths - Strangeways here we come
Bruce Springsteen - Tunnel of love
10,000 Maniacs - In my tribe
That petrol emotion - Babble
'Till Tuesday - Welcome home
Trouble Funk - Trouble over here, trouble over there
U2 - The Joshua tree
Jennifer Warnes - Famous Blue Raincoat
Stevie Wonder - Characters
