@{"upper":"false","parenthese":"false","removeAfter":"false","type":"ALBUM","separator":"-","artistFirst":"true","auteur":"Q","sorted":"false","size":"50","cat":"YEAR","rangeB":"2000","publish":"2000","name":"Q - Album - 2000","reverseArtist":"false","create":"28/08/2018 11:37:57","rangeE":"2000"}
Coldplay - Parachutes
AC/DC - Stiff Upper Lip
Badly Drawn Boy - The Hour Of Bewilderbeast
Beautiful South - Painting It Red
Black Box Recorder - The Facts Of Life
Bloodhound Gang - Hooray For Boobies
Brothers In Sound - Family Is For Sharing
Johnny Cash - American III: Solitary Man
D'Angelo - Voodoo
The Dandy Warhols - Thirteen Tales From Urban Bohemia
Craig David - Born To Do It
Doves - Lost Souls
Dr Dre - 2001
Eels - Daisies Of The Galaxy
Eminem - The Marshall Matherd Lp
Fatboy Slim - Halfway Between The Gutter And The Stars
Foo Fighters - There Is Nothing Left To Lose
Goldfrapp - Felt Mountain
Ruben Gonzalez - Chanchullo
Granddaddy - The Sophtware Slump
David Gray - White Ladder
Guru's Jazzmatazz - Streetsoul
Emmylou Harris - Red Dirt Girl
PJ Harvey - Stories From The City, Stories From The Sea
Graham Haynes - Bpm
JJ72 - JJ72
Kelis - Kaleidoscope
Lambchop - Nixon
Madonna - Music
Tom Mcrae - Tom Mcrae
Moloko - Things To Make And Do
Monster Magnet - God Says No
Muse - Showbiz
Nelly - Country Grammar
Oasis - Standing On The Shoulder Of Giants
Primal Scream - Exterminator
Q-Tip - Amplified
Queens Of The Stone Age - Rated R
Radiohead - Kid A
Jill Scott - Who The Fuck Is Jill Scott? Words And Sounds Vol 1
Paul Simon - You're The One
Sisqo - Unleash The Dragon
Elliott Smith - Figure 8
Angie Stone - Black Diamond
Toploader - Onka's Big Moka
U2 - All That You Can't Leave Behind
Kathryn Williams - Little Black Number
Robbie Williams - Sing When You're Winning
Wookie - Wookie
Neil Young - Silver And Gold
