@{"upper":"false","parenthese":"false","removeAfter":"false","type":"SONG","separator":"-","artistFirst":"true","auteur":"Fluxblog","sorted":"false","size":"100","cat":"YEAR","rangeB":"2020","publish":"2020","name":"Fluxblog - 2020","reverseArtist":"false","create":"13/01/2021 08:54:31","rangeE":"2020"}
Tame Impala - One More Year
No Joy - Four
King Krule - Stoned Again
Activity - Violent and Vivisect
Locate S,1 - After The Final Rose
BLACKPINK - Ice Cream (with Selena Gomez)
Lady Gaga - Stupid Love
Dua Lipa - Pretty Please
Roisin Murphy - Incapable
Jessie Ware - Mirage (Don't Stop)
Caribou - New Jade
Lil Uzi Vert - Venetia
Terrace Martin - Pig Feet (And Kamasi Washington, G Perico And Daylyt)
Run The Jewels - JUsT (And Pharrell Williams And Zack de la Rocha)
Cardi B - WAP (And Megan Thee Stallion)
Megan Thee Stallion - Captain Hook
Playboi Carti - Beno!
Trippie Redd - YELL OH
Lil Mosey - Blueberry Faygo
Ariana Grande - my hair
Victoria Monet - Moment
Linden Jay - Got Me All Wrong
Norah Jones - Hurts To Be Alone
St. Panther - These Days
Fiona Apple - Ladies
Bob Dylan - False Prophet
Stephen Malkmus - Brainwashed
Taylor Swift - invisible string
Taylor Swift - 'tis the damn season
Jana Horn - Time Machine
Selena Gomez - Cut You Off
Margaret Glaspy - You've Got My Number
Four Tet - Baby
CINTHIE - Bassline
Jayda G - Both Of Us
Gimgigam - Dunia Kuu
SAULT - Monsters
SAULT - Free
Lex Amor - Odogwu (Freestyle)
Busta Rhymes - Look Over Your Shoulder (And Kendrick Lamar)
Mr. Muthafuckin' eXquire - Black Mirror
Kiina - Erica
Freddie Gibbs - Something to Rap About (And Tyler, The Creator)
Pop Smoke - Yea Yea
Ego Ella May - How Long 'Til We're Home
drea the vibe dealer - Catastrophe
Faye Webster - In A Good Way
Kate Bollinger - A Couple Things
Ultraista - Tin King
Hanni El Khatib - STRESSY
Osees - Red Study
Miley Cyrus - Bad Karma (And Joan Jett)
Pearl Jam - Never Destination
Car Seat Headrest - Hollywood
Melkbelly - LCR
Chemtrails - Slag Heap Deity 1
Strawberry Generation - When You Were Here And I Was Sad
Destroyer - It Just Doesn't Happen
Caroline Rose - Do You Think We'll Last Forever?
Winter - Say
beabadoobee - Care
Soccer Mommy - circle the drain
of Montreal - Polyaneurism
Sofie - Melody
otta - just like the rain
Buscabulla - NTE (Jonti Remix)
Adrian Younge - Synchronize Vibration
Cleo Sol - When I'm in Your Arms
The Silhouettes Project - At the Bay
Jeff Parker - Gnarciss
John Carroll Kirby - Blueberry Beads
Gabriels - Love and Hate in a Different Time
Moodymann - Do Wrong
Powfu - death bed (coffee for your head)
Theophilus London - Marchin'
Childish Gambino - 35.31
Mac Miller - Good News
Saweetie - Tap In
City Girls - Jobs
James Blake - Do You Ever
Burial - Chemz
Travis Scott - FRANCHISE (And Young Thug And M.I.A.)
Amine - Shimmy
Earl Sweatshirt - WHOLE WORLD (And Maxo)
Jhene Aiko - P*ssY Fairy (OTW)
Chloe x Halle - Do It
BigKlit - What That Mouth Do
Denzel Curry - DIET_
Isaiah Rashad - Why Worry
Fana Hues - Notice Me
spill tab - Calvaire
Ingrid Andress - More Hearts Than Mine
Morgan Wallen - 7 Summers
Margo Price - Stone Me
Kelsea Ballerini - hole in the bottle (with Shania Twain)
Sorry - Right Round The Clock
Overcoats - Apathetic Boys
Poppy - I Disagree
Okay Kaya - Comic Sans
Jenny O. - Color Love
