@{"upper":"false","parenthese":"false","removeAfter":"false","type":"SONG","separator":"-","artistFirst":"true","auteur":"Fluxblog","sorted":"false","size":"294","cat":"YEAR","rangeB":"1997","publish":"2017","name":"Fluxblog - 1997 Songs - 2017","reverseArtist":"false","create":"27/07/2018 11:27:49","rangeE":"1997"}
Radiohead - Airbag
Sleater-Kinney - One More Hour
Cornershop - Brimful of Asha
Bjork - Alarm Call
Missy Elliott - The Rain (Supa Dupa Fly)
The Notorious B.I.G. - Hypnotize
Wu-Tang Clan - Reunited
Puff Daddy And Lil' Kim, The LOX and The Notorious B.I.G. - It's All About the Benjamins
Busta Rhymes - Put Your Hands Where My Eyes Can See
Daft Punk - Around the World
Atari Teenage Riot - Destroy 2000 Years of Culture
Blur - On Your Own
Pavement - Stereo
Shania Twain - Love Gets Me Every Time
Hanson - MMMBop
Robyn - Do You Know (What It Takes)
All Saints - Never Ever
Spiritualized - Ladies and Gentlemen, We Are Floating In Space
The Verve - Bitter Sweet Symphony
The Dandy Warhols - Boys Better
Oasis - Be Here Now
Veruca Salt - Don't Make Me Prove It
Shudder to Think - Survival
Modest Mouse - Polar Opposites
Jonathan Fire Eater - This Is My Room
Primal Scream - Star
Latyrx - Lady Don't Tek No
Mos Def - If You Can Huh...
Funkmaster Flex And Boot Camp Clik, Cocoa Brovaz, Heltah Skeltah, O.G.C., Ranks, Ms. Twanie, Swan Da Boodah Junkie, and The Representativz - Freestyle #11
Yo La Tengo - Autumn Sweater
Belle And Sebastian - Lazy Line Painter Jane
The Geraldine Fibbers - You Doo Right
Ani DiFranco - Firedoor (Live)
Ben Folds Five - Selfless, Cold, and Composed
Wyclef Jean - Gone Till November (Pop Version)
Stereolab - Brakhage
Janet Jackson And Q-Tip - Got Till It's Gone
Portishead - Only You
Tricky - Makes Me Wanna Die
2Pac - Do For Love
Mariah Carey - Honey
Lord Tariq And Peter Gunz - Deja Vu (Uptown Baby)
Lil Kim And Angie Martinez, Left Eye, Da Brat And Missy Elliott - Not Tonight (Remix)
The Chemical Brothers - Block Rockin' Beats
Nine Inch Nails - The Perfect Drug
GusGus - Why
Aphex Twin - Flim
Depeche Mode - Home
The Cure - Wrong Number
U2 - Gone
Natalie Imbruglia - Torn
Foo Fighters - Everlong
Celine Dion - My Heart Will Go On
Elliott Smith - Ballad of Big Nothing
The Make Up - Pow! to the People
Helium - Leon's Space Song
Company Flow - The Fire In Which You Burn
Freak Nasty - Da' Dip
Usher - You Make Me Wanna
Erykah Badu - Apple Tree
Capone-N-Noreaga - T.O.N.Y.
Scarface And 2Pac And Johnny P - Smile
Camp Lo - Luchini (A.K.A. This Is It)
Kool Keith - Sex Style
The Prodigy - Smack My Bitch Up
Rammstein - Du Hast
Godspeed You! Black Emperor - The Dead Flag Blues
Bis - Tell It to the Kids
Papas Fritas - Sing About Me
Plumtree - Scott Pilgrim
That Dog - Gagged and Tied
Ween - Ocean Man
David Byrne - Finite = Alright
Backstreet Boys - Everybody (Backstreet's Back)
Master P And Silkk the Shocker, Fiend, Mia X and Mystikal - Make 'Em Say Uhh
Mase - Feel So Good
LL Cool J And Method Man, Redman, Canibus And DMX - 4, 3, 2, 1
Street Smartz And OC And Pharoahe Monch - Metal Thangz
Armand Van Helden - Hot Butter
Dub Narcotic Sound System - Bass Hump
Dru Hill - In My Bed
Jay-Z - The City Is Mine
Mary J. Blige And Lil Kim - I Can Love You
Pulp - Help the Aged
Fiona Apple - Sleep to Dream
Massive Attack - Risingson
DJ Shadow - High Noon
Buena Vista Social Club - Chan Chan
Bob Dylan - Love Sick
Green Day - Good Riddance (Time of Your Life)
George Strait - One Night At A Time
Leann Rimes - How Do I Live
Garth Brooks - Longneck Bottle
Bloodhound Gang - Fire Water Burn
Blink-182 - Dammit
The Get Up Kids - Don't Hate Me
Marcy Playground - Sex and Candy
Sarah McLachlan - Building A Mystery
R.E.M. - Electrolite
Sonic Youth - Anagrama
Mogwai - Like Herod
Air - Le soleil est pres de moi
Broadcast - Lights Out
Roni Size And Reprazent - Railing
The X-Ecutioners - Musica Negra (Black Music)
Boot Camp Clik - Illa Noyz
Destiny's Child - No, No, No Pt. 2
Timbaland and Magoo - Up Jumps Da Boogie
The Orb - Toxygene
Underworld - Pearl's Girl
Fluke - Atom Bomb
Tha Alkaholiks And Ol' Dirty Bastard - Hip Hop Drunkies
Brian McKnight - You Should Be Mine (Don't Waste Your Time)
Plug - Subtle (In Your Face)
Lords of Acid - Pussy
David Bowie - I'm Afraid of Americans
The Smashing Pumpkins - Eye
Twista - Get It Wet
Korn And The Dust Brothers - Kick the P.A.
Organized Konfusion - Invetro
Hieroglyphics - The Who (A-Plus Remix)
The Firm - Phone Tap
Sugar Ray - Fly
Save Ferris - Come On Eileen
Mighty Mighty Bosstones - The Impression That I Get
Smash Mouth - Walkin' on the Sun
Live - Lakini's Juice
Built to Spill - I Would Hurt A Fly
The Dismemberment Plan - The Ice of Boston
Guided by Voices - Sad If I Lost It
Kylie Minogue - I Don't Need Anyone
Beck - Deadweight
Elastica And Stephen Malkmus - Unheard Muzik
Matthew Sweet - Come to California
Third Eye Blind - Semi-Charmed Life
Chumbawamba - Tubthumping
White Town - Your Woman
SWV And Puff Daddy - Someone
Mouse On Mars - Juju
The Flaming Lips - Okay, I'll Admit That I Really Don't Understand
Clinic - Porno
Smog - Ex-Con
Texas - Black Eyed Boy
The Pietasters - Out All Night
Less Than Jake - Automatic
Everclear - I Will Buy You A New Life
Lonestar - Come Cryin' to Me
Tim McGraw And Faith Hill - It's Your Love
Steve Earle - Somewhere Out There
Mindy McCready - Oh Romeo
Whiskeytown - 16 Days
Ivy - The Best Thing
NSYNC - Here We Go
Ray J - Let It Go
Common - Reminding Me
Dionne Farris - Hopeless
Zony Mash - Cold Spell
DJ Vadim - Conquest of the I
Coldcut - More Beats And Pieces (Daddy Rips It Up Mix)
Crystal Method - Busy Child
Merril Bainbridge - Mouth
Bush - Mouth (The Stingray Mix)
Mineral - Five, Eight, and Ten
Luna - Tracy I Love You
Lifetime - Turnpike Gates
MxPx - Move to Bremerton
NoFX - It's My Job to Keep Punk Rock Elite
Royal Trux - Don't Try Too Hard
The Beatnuts And Big Punisher and Cuban Linx - Off the Books
Redman And Erick Sermon - Whateva Man
Mobb Deep And Rakim And Big Noyd - Hoodlum
Mia X - The Party Don't Stop (Funky Mix)
Jedi Mind Tricks - The Winds of War
DJ Krush - Shin-Sekai
u-Ziq - Hasty Boom Alert
Plaid - Kortisin
Thievery Corporation - Weightless
Aqua - Barbie Girl
Gina G - Ooh Aah (Just A Little Bit)
Spice Girls - Spice Up Your Life
INXS - Elegantly Wasted
Blue Boy - Remember Me
High And Mighty - It's All for You
Young Bleed And Master P And C-Loc - How Ya Do Dat
Mystikal - Ain't No Limit
Mack 10 - Backyard Boogie
Makaveli And The Outlawz - Hail Mary
112 - Cupid
Keith Sweat - Nobody
Mic Geronimo And DMX, Ja Rule, Tragey, and The LOX - Usual Suspects
Gang Starr - You Know My Steez
EPMD - Da Joint
Reflection Eternal - Fortified Live
Meat Beat Manifesto - It's the Music
KMFDM - Megalomaniac
Morcheeba - Shoulder Holster
Mouse on Mars - Juju
Savage Garden - Truly Madly Deeply
Duncan Sheik - Barely Breathing
Shawn Colvin - Sunny Came Home
Kenny Chesney - She Got It All
Mark Chesnutt - It's A Little Too Late
Paul McCartney - The World Tonight
Superchunk - Watery Hands
Cursive - After the Movies
Travis - All I Want To Do Is Rock
Gorky's Zygotic Mynci - Diamond Dew
Old 97's - Timebomb
Ben Harper - Faded
Knapsack - Courage Was Confused
Sleeper - She's A Good Girl
Rainer Maria - Viva Anger, Viva Hate
Lida Husik - Fly Stereophonic
The Sundays - Summertime
Deana Carter - We Danced Anyway
Paula Cole - I Don't Want to Wait
Tool - Ænema
Marilyn Manson - Tourniquet
Metallica - The Memory Remains
The Lady of Rage - Some Shit
Mr. Complex - Visualize
DJ Muggs And Mobb Deep - It Could Happen to You
Next - Butta Love
Allure - All Cried Out
Amon Tobin - Stoney Street
Pizzicato Five - Love's Theme
Laika - Almost Sleeping
David Holmes - Don't Die Just Yet
Mr. President - Coco Jamboo
Yvette Michelle - I'm Not Feeling You
Bone Thugs N Harmony - Look Into My Eyes
En Vogue - Don't Let Go (Love)
Chantal Kreviazuk - God Made Me
Abra Moore - Four Leaf Clover
Kenickie - Punka
Deftones - Be Quiet and Drive
Morrissey - Maladjusted
Filter - (Can't You) Trip Like I Do
AZ Yet - Hard To Say I'm Sorry
Something for the People - My Love is the Shhhh
Changing Faces - G.H.E.T.T.O.U.T.
Warren G - I Shot the Sheriff
Tela - Tired of Ballin'
Diamond D And Pete Rock and Phife Dawg - Painz And Strife
R.A. the Rugged Man - Till My Heart Stops
Rampage And Busta Rhmyes - Wild for Da Nite
Archers of Loaf - Jive Kata
Toad the Wet Sprocket - Come Down
Sister Hazel - All for You
Fivel - Convict Grass
My Drug Hell - 2 A.M.
Aerosmith - Pink
Pulsars - Tunnel Song
At the Drive-In - Give It A Name
Thomas Jefferson Slave Apartments - Lightin' Rod
Gene - Where Are They Now?
Cherry Poppin' Daddies - Zoot Suit Riot
Primus - Bob's Party Time Lounge
Slipknot - Slipknot
Creed - My Own Prison
Limp Bizkit - Counterfeit
Insane Clown Posse - Halls of Illusions
311 - Beautiful Disaster
The Offspring - Gone Away
Incubus - New Skin
Silverchair - Abuse Me
Days of the New - Touch, Peel, and Stand
Tonic - If You Could Only See
Matchbox 20 - Push
Edwin McCain - I'll Be
Guster - Airport Song
Summercamp - Drawer
Placebo - Nancy Boy
Smoking Popes - I Know You Love Me
Real McCoy - One More Time
R. Kelly - Gotham City
Will Smith - Men In Black
Da Brat - Ghetto Love
Coolio - C U When You Get There
Joe - Don't Wanna Be A Player
Mark Morrison - Return of the Mack
Gravediggaz - Dangerous Mindz
Mansun - She Makes My Nose Bleed
Death In Vegas - Rocco
Photek - KJZ
Diamond Rio - How Your Love Makes Me Feel
Atmosphere - Sound Is Vibration
Big Mike - Burban And Impalas
Total And Timbaland - What About Us
Boyz II Men - 4 Seasons of Loneliness
98 Degrees - Invisible Man
Bob Carlisle - Butterfly Kisses
Barbra Streisand And Bryan Adams - I Finally Found Someone
Elton John - Candle in the Wind 1997 
