@{"upper":"false","parenthese":"false","removeAfter":"false","type":"SONG","separator":"-","artistFirst":"true","auteur":"Fluxblog","sorted":"false","size":"89","cat":"LONG_PERIOD","rangeB":"2002","publish":"2018","name":"Fluxblog - 16 Years Of Unpopular Pop (2002-2018) - 2018","reverseArtist":"false","create":"27/07/2018 10:42:25","rangeE":"2018"}
Scissor Sisters - Paul McCartney
In Flagranti - Genital Blue Room
Spektrum - Don't Be Shy
Goldfrapp - Ride A White Horse
The Silures - 21 Ghosts
Basement Jaxx - Cish Cash
Rachel Stevens - Some Girls
Klanguage - Never Over
Kylie Minogue - Sweet Music
Annie - Chewing Gum
Pleasure - Out of Love
Architecture in Helsinki - That Beep
Out Hud - It's For You
Matthew Dear - Don and Sherri
Bossanova - Rare Brazil
Enon - Daughter in the House of Fools
Katy Rose - Rosemary
Fox N' Wolf - Youth Alcoholic
The Knife - Heartbeats
Revl9n - Walking Machine
AG Cook And Hannah Diamond - Keri Baby
GFOTY - Don't Wanna/Let's Do It
Poppy - My Style
Grimes - Artangels
White Hinterland - Chill and Natural
Von Sudenfed - Fledermaus Can't Get It
Bjork - Innocence
Justice - DVNO
Kate Nash - Pumpkin Soup
Yelle - Tristesse/Joie
Girls Aloud - Black Jacks
Veronica Maggio - Gammal Sang
Kimbra - Madhouse
Hemme Fatale - Animal Lover
Alphabeat - Heatwave
Ellie Goulding - Anything Could Happen
Sissy Wish - Float
Fight Like Apes - Pop Itch
Carly Rae Jepsen - Tiny Little Bows
Brown Eyed Girls - ????
Junior Senior - We R the Handclaps
Gameboy/Gamegirl - Sweaty Wet/Dirty Damp
Muscles - Chocolate, Raspberry, Lemon, and Lime
Crossover - Extensive Care
Sleigh Bells - Crown on the Ground
Maria Magdalena - CVMC (Cada Vez Mas Cerca)
Friendly Fires - Hurting
The Rapture - Whoo! Alright – Yeah... Uh-Huh
M.I.A. - URAQT
Ce'cile - Rude Bwoy Thug Life
Redinho - Playing with Fire
CSS - Let's Make Love and Listen to Death From Above
Spank Rock - Sweet Talk
Stazi - Love Is Lethal
Yellow Note vs. Pukka - Naked, Drunk, and Horny
Armand Van Helden And Spalding Rockwell - Hear My Name
Cut Copy - Saturdays
Quarks - I Walk
QT - Hey QT
Peaches - Dumb Fuck
Heloise and the Savoir Faire Dancers - Odyle
Tracy and the Plastics - Henrietta
Junesex - Gets Close to Mine
Mouse on Mars - Mine Is In Yours
LCD Soundsystem - Yeah (Crass Version)
Ladytron - Destroy Everything You Touch
Of Montreal - The Party's Crashing Us (I Am the World Trade Center Remix)
Futon - Gay Boy
Dog Ruff - Jon E Storm
Chicks on Speed - Shick Shaving
Avenue D And Cazwell - The Sex That I Need
Gene Serene - Electric Dreams
Vanessinha And Alessandra - Gira
United State of Electronica - La Discoteca
Planningtorock - I Wanna Bite Ya
Nouveau Riche - Take Me Home
Hilary Duff - Danger
SEVENTEEN - Change Up
Britney Spears - How I Roll
MNDR - Cut Me Out
Skrillex - Stranger
Sophie - Lemonade
Saint Pepsi - Better
Sky Ferreira - I Blame Myself
Lolita Storm - Dancing with the Ibiza Dogs
Chairlift - I Belong In Your Arms
Au Revoir Simone - Through the Backyards
La Big Vic - All That Heaven Allows
Rework - Not Quite Like Any Other
