@{"upper":"false","parenthese":"false","removeAfter":"false","type":"SONG","separator":"-","artistFirst":"true","auteur":"Fluxblog","sorted":"false","size":"293","cat":"YEAR","rangeB":"1999","publish":"2017","name":"Fluxblog - 1999 Songs - 2017","reverseArtist":"false","create":"27/07/2018 12:04:58","rangeE":"1999"}
Kid Rock - Bawitdaba
Limp Bizkit - Nookie
Rage Against the Machine - Sleep Now in the Fire
DMX - Party Up
Jay-Z And UGK - Big Pimpin'
Ol Dirty Bastard And Kelis - Got Your Money
Eminem - My Name Is
Smash Mouth - All Star
LEN - Steal My Sunshine
Fatboy Slim - Praise You
Beck - Debra
Macy Gray - I Try
Basement Jaxx - Red Alert
The Chemical Brothers And Noel Gallagher - Let Forever Be
Ben Folds Five - Army
The Flaming Lips - The Gash
The Magnetic Fields - The Death of Ferdinand de Saussure
Aimee Mann - Save Me
Fiona Apple - Paper Bag
Sleater-Kinney - Hot Rock
Belle And Sebastian - Slow Graffiti
Royal Trux - Stop
Sloan - Don't You Believe A Word
The Roots - The Next Movement
Method Man And Redman - Cheka
Mos Def - Ms. Fat Booty
Lauryn Hill - Ex-Factor
Le Tigre - Deceptacon
Clinic - The Second Line
Nine Inch Nails - Into the Void
Joan of Arc - Me (Plural)
Mogwai - Year 2000 Non-Compliant Cardia
Pavement - The Hexx
Blur - No Distance Left to Run
Christina Aguilera - What A Girl Wants
Mariah Carey And Jay-Z - Heartbreaker
Britney Spears - (You Drive Me) Crazy
Shania Twain - Man! I Feel Like A Woman!
Guided by Voices - Teenage FBI
The Dismemberment Plan - A Life of Possibilities
April March - Sugar
The Make Up - Born on the Floor
Stereolab - The Free Design
The Rock*A*Teens - Across the Piedmont
The Rentals - Big Daddy C
Wilco - A Shot in the Arm
Bonnie - Prince
Billy - A Minor Place
Backstreet Boys - I Want It That Way
Sixpence None the Richer - Kiss Me
Red Hot Chili Peppers - Scar Tissue
Pharoahe Monch - Simon Says
Common And Sadat X - 1999
Dr. Dre And Snoop Dogg - Still D.R.E.
Memphis Bleek - Memphis Bleek Is...
The High And Mighty And Mos Def and Mad Skillz - B-Boy Document 99
Handsome Boy Modeling School - Rock n' Roll (Could Never Hip Hop Like This)
Bloodhound Gang - The Bad Touch
TLC - No Scrubs
Destiny's Child - Bills, Bills, Bills
Chris Gaines - Lost In You
Vitamin C - Smile
Sugar Ray - Every Morning
Fountains of Wayne - Utopia Parkway
Home - Truly Judy
Tricky - For Real
Tori Amos - Glory of the '80s
GusGus - Bambi
Sigur Ros - Svefn-G-Englar
Mercury Rev - Holes
Shelby Lynne - Dreamsome
Luna - Superfreaky Memories
Kool Keith - Livin' Astro
MF Doom - Rhymes Like Dimes
Tom Green - Lonely Swedish (The Bum Bum Song)
Built to Spill - The Plan
Sebadoh - Flame
Madonna - Beautiful Stranger
Bis - Making People Normal
Gorky's Zygotic Mynci - Poodle Rockin'
The Auteurs - How I Learned to Love the Bootboys
Prince Paul And Kool Keith - Weapon World
D'Angelo And Method Man and Redman - Left and Right
The Beta Band - It's Not Too Beautiful
Roots Manuva - Juggle Tings Proper
Aphex Twin - Windowlicker
Clinton - People Power in the Disco Hour
Missy Elliott - She's A Bitch
Cassius - Cassius 1999
Moby - Bodyrock
Q-Tip - Vivrant Thing
Master P - Step to Dis
Goodie Mob And TLC - What It Ain't (Ghetto Enuff)
E-40 - Big Ballin' with My Homies
Aaliyah - I Don't Wanna
Ladytron - He Took Her To A Movie
Apples in Stereo - Strawberryfire
U.S. Maple - Breeze, It's Your High School
Jim O'Rourke - Ghost Ship In A Storm
R.E.M. - The Great Beyond
Songs: Ohia - Love Leaves Its Abusers
Dixie Chicks - You Were Mine
Martina McBride - I Love You
American Football - Never Meant
Blink-182 - What's My Age Again
Jimmy Eat World - For Me This Is Heaven
Rainer Maria - Rise
Ani DiFranco - Angry Anymore
Faith Hill - Breathe
Smog - Teenage Spaceship
Godspeed You Black Emperor - Moya
Bjork - All Is Full of Love (Video Version)
Baz Luhrmann - Everybody's Free (To Wear Sunscreen)
Chris Rock - No Sex in the Champagne Room
Eve - Gotta Man
Terror Squad And Big Pun - Whatcha Gon Do
Project Pat And Noreaga and Tear Da Club Up Thugs - Represent It
Lil Wayne - Tha Block Is Hot
Dr. Dooom - Apartment 223
Peanut Butter Wolf And Planet Asia - Definition of Ill
Raekwon - Live from New York
Whitney Houston - It's Not Right But It's Okay (Thunderpuss Mix)
Foxy Brown And Total - I Can't
Mary J. Blige And Lauryn Hill - All That I Can Say
Kim English - Unspeakable Joy
Vengaboys - We Like to Party!
Lou Bega - Mambo No. 5
Ricky Martin - Livin' La Vida Loca
Paul Johnson - Get Get Down
Pete Heller - Big Love (Original Club Mix)
Mr. Oizo - Flat Beat
Armand Van Helden And Duane Harden - U Don't Know Me
Pet Shop Boys - New York City Boy
Cibo Matto - Working for Vacation
LFO - Summer Girls
Papa M - Roadrunner
The Folk Implosion - Free to Go
At the Drive-In - 198d
Foo Fighters - Breakout
The Get Up Kids - Holiday
Modest Mouse - You're the Good Things
Beulah - Score from Augusta
Rilo Kiley - The Frug
Pearl Jam - Last Kiss
Kenny Chesney - How Forever Feels
Jo Dee Messina - Stand Beside Me
Lonestar - Amazed
Beth Orton - Central Reservation
Darude - Sandstorm
Eiffel 65 - Blue (Da Ba Dee)
Azzido Da Bass - Dooms Night (Timo Maas Mix)
Mouse on Mars - Diskdusk
Leftfield And Roots Manuva - Dusted
Orbital - Style
Underworld - Push Upstairs
Primal Scream - Swastika Eyes
Gramm - Legends/Nugroove
Plone - Plock
Aspen - Are You That Retail Snob?
Susumu Yokota - Tobiume
Drexciya - Drifting Into A Time of No Future
Arovane - pInt
D'Arcangelo - Shipwreck
To Rococo Rot - Prado
CiM - Comfort Control
Peter Bench - Part IX
Sturm - Untitled 3
Rank 1 - Airwave
GAS - Konigsforst 1
Gouryella - Gouryella (Extended)
Everything But the Girl - Five Fathoms
B. Fleischmann - Le Matin
Proem - Drool Master
Fantomas - Book 1: Page 4
Monolake - Ginza
Phonem - Bitstream
Bardo Pond - Walking Stick Man
Sam Prekop - Showrooms
Four Tet - The Space of Two Weeks
Nightmares on Wax - Finer
Puff Daddy feat R. Kelly - Satisfy You
Lit - My Own Worst Enemy
Buckcherry - Lit Up
Stone Temple Pilots - Sour Girl
Brad Paisley - He Didn't Have to Be
Clint Black - When I Said I Do
Archer Prewitt - Raise on High
Pedro the Lion - Be Thou My Vision
Sonic Youth - Six for New Time
Fly Pan Am - Bibi A Nice, 1921
Tarentel - Steede Bonnet
Terri Clark - You're Easy on the Eyes
Counting Crows - Hanginaround
Santana And Rob Thomas - Smooth
Chely Wright - Single White Female
Olivia Tremor Control - Hideway
Death In Vegas - Aisha
Terrance and Phillip - Uncle Fucka
Nas And Puff Daddy - Hate Me Now
Silkk the Shocker And Master P - Ghetto Rain
Dido - Here With Me
R. Kelly And Celine Dion - I'm Your Angel
Enrique Iglesias - Bailamos
M2M - Don't Say You Love Me
Pocket Size - Walking
Supergrass - Pumping On Your Stereo
Super Furry Animals - Northern Lights
And You Will Know Us By the Trail of Dead - Mistakes and Regrets
Robbie Williams - Strong
Sara Evans - No Place That Far
Scharpling And Wurster - Rock, Rot, and Rule (excerpt)
The Faint - Worked Up So Sexual
The White Stripes - The Big Three Killed My Baby
Saves the Day - Shoulder to the Wheel
New Found Glory - Hit or Miss
Planes Mistaken for Stars - Copper and Stars
The Promise Ring - Become One Anything One
Low - Starfire
The American Analog Set - Weather Report
u-Ziq - The Fear
Blaque - 808
702 - Where My Girls At
Busta Rhymes And Janet Jackson - What's It Gonna Be
Black Eyed Peas - Joints and Jam
Will Smith - Miami
Monica - Angel of Mine
The Divine Comedy - Gin Soaked Boy
Randy Newman - Shame
Kahimi Karie - Elastic Girl
Khan - Body Dump
Hot Boys - We On Fire
Korea Girl - Under the Sun
Citizen King - Better Days
Deborah Cox - It's Over Now
Sisqo - Got to Get It
Amber - Sexual (Li Da Li)
Guitar Wolf - Jet Generation
Further Seems Forever - New Year's Project
Piebald - Grace Kelly with Wings
Superchunk - Hello Hawk
Chris Cornell - Can't Change Me
Blondie - Maria
Badly Drawn Boy - It Came from the Ground
Ataris - I Won't Spend Another Night Alone
AFI - The Prayer Position
Burning Airlines - Pacific 231
The Casket Lottery - Midway
Tristeza - A Little Distance
Mark Wills - Wish You Were Here
Mark Chesnutt - I Don't Want to Miss A Thing
NSYNC - Thinking of You (I Drive Myself Crazy)
Silverchair - Ana's Song
Bright Eyes - A Perfect Sonnet
Creed - Higher
Live - The Dolphin's Cry
No Doubt - New
Bush - The Chemicals Between Us
Korn - Freak On A Leash
Powerman 5000 - When Worlds Collide
Orgy - Blue Monday
Linkin Park - High Voltage
The Offspring - Why Don't You Get A Job
Faith Evans and Puff Daddy - All Night Long
Jennifer Lopez - If You Had My Love
Marc Anthony - I Need to Know
Chante Moore - Chante's Got A Man
Stroke 9 - Little Black Backpack
The Dillinger Escape Plan - Sugar Coated Sour
Slipknot - Spit It Out
Ministry - Bad Blood
Filter - Take A Picture
Tal Bachman - She's So High
98 Degrees - I Do (Cherish You)
Brandy - Have You Ever
Eric Benet - Spend My Life With You
JT Money - Who Dat
Groove Armada - I See You Baby
Ja Rule - Holla Holla
Tyrese - Sweet Lady
GZA - Beneath the Surface
Jamiroquai - Canned Heat
Moloko - Sing It Back (Tee's Radio Mix)
Geri Halliwell - Lift Me Up
Ronan Keating - When You Say Nothing At All
Martine McCutcheon - Perfect Moment
Westlife - Swear It Again
Pop Unknown - Half of Ninety
The Smashing Pumpkins - The Everlasting Gaze
Fu Manchu - Eatin' Dust
Turbonegro - Get It On
XTC - Easter Theater
David Bowie - The Dreamers
Fugazi - I'm So Tired 
